xxxxxxx	XXXXXXXXX
OPENLOCATION	JOBLOCATION
ACCOUNTING DEGREE	DEGREEPROGRAM
ADULT EDUCATION DEGREE	DEGREEPROGRAM
ADVERTISING DEGREE	DEGREEPROGRAM
AFRICAN AMERICAN STUDIES DEGREE	DEGREEPROGRAM
ANIMATION DEGREE	DEGREEPROGRAM
ANTHROPOLOGY DEGREE	DEGREEPROGRAM
ARCHAEOLOGY DEGREE	DEGREEPROGRAM
ARCHITECTURE DEGREE	DEGREEPROGRAM
ART DEGREE	DEGREEPROGRAM
ART HISTORY DEGREE	DEGREEPROGRAM
ARTS DEGREE	DEGREEPROGRAM
ASIAN STUDIES DEGREE	DEGREEPROGRAM
BACHELOR OF DESIGN DEGREE	DEGREEPROGRAM
BEHAVIORAL OR SOCIAL SCIENCES DEGREE	DEGREEPROGRAM
BEHAVIORAL SCIENCE DEGREE	DEGREEPROGRAM
BEHAVIORAL SCIENCES DEGREE	DEGREEPROGRAM
BEHAVIOURAL OR SOCIAL SCIENCES DEGREE	DEGREEPROGRAM
BEHAVIOURAL SCIENCE DEGREE	DEGREEPROGRAM
BEHAVIOURAL SCIENCES DEGREE	DEGREEPROGRAM
BIOCHEMISTRY DEGREE	DEGREEPROGRAM
BIOLOGICAL STUDIES DEGREE	DEGREEPROGRAM
BIOLOGY DEGREE	DEGREEPROGRAM
BIOMEDICAL DEGREE	DEGREEPROGRAM
BIOTECHNOLOGY DEGREE	DEGREEPROGRAM
BUSINESS ADMINISTRATION DEGREE	DEGREEPROGRAM
BUSINESS COMMUNICATION DEGREE	DEGREEPROGRAM
BUSINESS DEGREE	DEGREEPROGRAM
BUSINESS INFORMATION SYSTEMS DEGREE	DEGREEPROGRAM
BUSINESS MANAGEMENT DEGREE	DEGREEPROGRAM
CG ART DEGREE	DEGREEPROGRAM
CG DESIGN DEGREE	DEGREEPROGRAM
CHEMICAL ENGINEERING DEGREE	DEGREEPROGRAM
CHEMISTRY DEGREE	DEGREEPROGRAM
CHILD DEVELOPMENT DEGREE	DEGREEPROGRAM
CHOREOGRAPHY DEGREE	DEGREEPROGRAM
CINEMATOGRAPHY DEGREE	DEGREEPROGRAM
CIVIL ENGINEERING DEGREE	DEGREEPROGRAM
CLASSICS DEGREE	DEGREEPROGRAM
COGNITIVE PSYCHOLOGY DEGREE	DEGREEPROGRAM
COGNITIVE SCIENCE DEGREE	DEGREEPROGRAM
COMMERCE DEGREE	DEGREEPROGRAM
COMMUNICATIONS DEGREE	DEGREEPROGRAM
COMPUTER SCIENCE DEGREE	DEGREEPROGRAM
COMPUTER SCIENCE/MIS DEGREE	DEGREEPROGRAM
CONSTRUCTION MANAGEMENT DEGREE	DEGREEPROGRAM
COUNSELING DEGREE	DEGREEPROGRAM
CRIMINAL JUSTICE DEGREE	DEGREEPROGRAM
CRIMINOLOGY DEGREE	DEGREEPROGRAM
CRIMINOOLOGY DEGREE	DEGREEPROGRAM
CYBER SECURITY DEGREE	DEGREEPROGRAM
DANCE DEGREE	DEGREEPROGRAM
DESIGN DEGREE	DEGREEPROGRAM
DIGITAL MEDIA DEGREE	DEGREEPROGRAM
EARLY CHILDHOOD DEGREE	DEGREEPROGRAM
EARLY CHILDHOOD EDUCATION DEGREE	DEGREEPROGRAM
EARLY CHILDHOOD SPECIAL EDUCATION DEGREE	DEGREEPROGRAM
ECONOMICS DEGREE	DEGREEPROGRAM
ELECTRIC ENGINEERING DEGREE	DEGREEPROGRAM
ELECTRICAL ENGINEERING DEGREE	DEGREEPROGRAM
ELECTRICAL OR MECHANICAL ENGINEERING DEGREE	DEGREEPROGRAM
ELECTRONIC ENGINEERING DEGREE	DEGREEPROGRAM
ENGINEERING DEGREE	DEGREEPROGRAM
ENGINEERING MANAGEMENT DEGREE	DEGREEPROGRAM
ENGLISH DEGREE	DEGREEPROGRAM
ENVIRONMENTAL ENGINEERING DEGREE	DEGREEPROGRAM
ENVIRONMENTAL SCIENCE DEGREE	DEGREEPROGRAM
EPIDEMIOLOGY DEGREE	DEGREEPROGRAM
FEMINIST STUDIES DEGREE	DEGREEPROGRAM
FILM DEGREE	DEGREEPROGRAM
FINANCE DEGREE	DEGREEPROGRAM
FINANCE/ACCOUNTING DEGREE	DEGREEPROGRAM
FINE ARTS DEGREE	DEGREEPROGRAM
FOOD SCIENCES DEGREE	DEGREEPROGRAM
FRENCH DEGREE	DEGREEPROGRAM
GENDER STUDIES DEGREE	DEGREEPROGRAM
GEOGRAPHY DEGREE	DEGREEPROGRAM
GEOLOGY DEGREE	DEGREEPROGRAM
GERMAN DEGREE	DEGREEPROGRAM
GRAPHIC DESIGN DEGREE	DEGREEPROGRAM
HEALTH ADMINISTRATION DEGREE	DEGREEPROGRAM
HEALTH POLICY DEGREE	DEGREEPROGRAM
HEALTH SCIENCE DEGREE	DEGREEPROGRAM
HEALTHCARE ADMINISTRATION DEGREE	DEGREEPROGRAM
HEALTHCARE DEGREE	DEGREEPROGRAM
HISTORY DEGREE	DEGREEPROGRAM
HISTOTECHNOLOGY DEGREE	DEGREEPROGRAM
HOSPITALITY MANAGEMENT DEGREE	DEGREEPROGRAM
HR DEGREE	DEGREEPROGRAM
HUMAN RESOURCE DEGREE	DEGREEPROGRAM
HUMAN RESOURCES DEGREE	DEGREEPROGRAM
HUMAN SERVICES DEGREE	DEGREEPROGRAM
INDUSTRIAL ENGINEERING DEGREE	DEGREEPROGRAM
INDUSTRIAL PSYCHOLOGY DEGREE	DEGREEPROGRAM
INFORMATION MANAGEMENT DEGREE	DEGREEPROGRAM
INFORMATION SCIENCE DEGREE	DEGREEPROGRAM
INFORMATION STUDIES DEGREE	DEGREEPROGRAM
INFORMATION SYSTEMS DEGREE	DEGREEPROGRAM
INSTRUCTIONAL DESIGN DEGREE	DEGREEPROGRAM
INSTRUCTIONAL TECHNOLOGY DEGREE	DEGREEPROGRAM
INTERNATIONAL BUSINESS DEGREE	DEGREEPROGRAM
INTERNATIONAL STUDIES DEGREE	DEGREEPROGRAM
IT DEGREE	DEGREEPROGRAM
IT RELATED DEGREE	DEGREEPROGRAM
ITALIAN DEGREE	DEGREEPROGRAM
JOURNALISM DEGREE	DEGREEPROGRAM
JUSTICE DEGREE	DEGREEPROGRAM
KINESIOLOGY DEGREE	DEGREEPROGRAM
LAW ENFORCEMENT DEGREE	DEGREEPROGRAM
LIBERAL ARTS DEGREE	DEGREEPROGRAM
LIBRARIANSHIP DEGREE	DEGREEPROGRAM
LIFE SCIENCES DEGREE	DEGREEPROGRAM
LINGUISTICS DEGREE	DEGREEPROGRAM
LITERATURE DEGREE	DEGREEPROGRAM
MANAGEMENT DEGREE	DEGREEPROGRAM
MANAGEMENT SCIENCE DEGREE	DEGREEPROGRAM
MARKETING DEGREE	DEGREEPROGRAM
MATERIALS SCIENCE DEGREE	DEGREEPROGRAM
MATHEMATICS DEGREE	DEGREEPROGRAM
MECHANICAL ENGINEERING DEGREE	DEGREEPROGRAM
MECHANICAL OR ELECTRICAL ENGINEERING DEGREE	DEGREEPROGRAM
MEDIA STUDIES DEGREE	DEGREEPROGRAM
MICROBIOLOGY DEGREE	DEGREEPROGRAM
MICRO-BIOLOGY DEGREE	DEGREEPROGRAM
MINING ENGINEERING DEGREE	DEGREEPROGRAM
MOLECULAR BIOLOGY DEGREE	DEGREEPROGRAM
MUSIC DEGREE	DEGREEPROGRAM
NETWORKS DEGREE	DEGREEPROGRAM
NEUROSCIENCE DEGREE	DEGREEPROGRAM
NUCLEAR ENGINEERING DEGREE	DEGREEPROGRAM
NURSING DEGREE	DEGREEPROGRAM
NUTRITION DEGREE	DEGREEPROGRAM
OPERATIONS MANAGEMENT DEGREE	DEGREEPROGRAM
ORGANIZATIONAL DEVELOPMENT DEGREE	DEGREEPROGRAM
PERFORMANCE ART DEGREE	DEGREEPROGRAM
PETROLEUM ENGINEERING DEGREE	DEGREEPROGRAM
PHARMACEUTICAL SCIENCE DEGREE	DEGREEPROGRAM
PHARMACOLOGY DEGREE	DEGREEPROGRAM
PHILOSOPHY DEGREE	DEGREEPROGRAM
PHOTOGRAPHY DEGREE	DEGREEPROGRAM
PHYSICS DEGREE	DEGREEPROGRAM
PHYSIOTHERAPY DEGREE	DEGREEPROGRAM
POLITICS DEGREE	DEGREEPROGRAM
PROGRAMMING DEGREE	DEGREEPROGRAM
PROJECT MANAGEMENT DEGREE	DEGREEPROGRAM
PSYCHOLOGY DEGREE	DEGREEPROGRAM
PUBLIC ADMINISTRATION DEGREE	DEGREEPROGRAM
PUBLIC HEALTH DEGREE	DEGREEPROGRAM
PUBLIC POLICY DEGREE	DEGREEPROGRAM
RECORDS MANAGEMENT DEGREE	DEGREEPROGRAM
REGISTERED NURSE DEGREE	DEGREEPROGRAM
RELIGION DEGREE	DEGREEPROGRAM
RN DEGREE	DEGREEPROGRAM
SCIENCES DEGREE	DEGREEPROGRAM
SOCIAL SCIENCE DEGREE	DEGREEPROGRAM
SOCIAL SCIENCES DEGREE	DEGREEPROGRAM
SOCIAL WORK DEGREE	DEGREEPROGRAM
SOCIOLOGY DEGREE	DEGREEPROGRAM
SPANISH DEGREE	DEGREEPROGRAM
SPORT SCIENCE DEGREE	DEGREEPROGRAM
SPORT SCIENCES DEGREE	DEGREEPROGRAM
SPORTS DEGREE	DEGREEPROGRAM
SPORTS SCIENCE DEGREE	DEGREEPROGRAM
SPORTS SCIENCES DEGREE	DEGREEPROGRAM
STATISTICS DEGREE	DEGREEPROGRAM
STRUCTURAL ENGINEERING DEGREE	DEGREEPROGRAM
SUPPLY CHAIN MANAGEMENT DEGREE	DEGREEPROGRAM
SYSTEM ENGINEERING DEGREE	DEGREEPROGRAM
SYSTEMS ENGINEERING DEGREE	DEGREEPROGRAM
TECHNICAL WRITING DEGREE	DEGREEPROGRAM
THEATER DEGREE	DEGREEPROGRAM
THEATRE DEGREE	DEGREEPROGRAM
TOXICOLOGY DEGREE	DEGREEPROGRAM
TRAINING AND DEVELOPMENT DEGREE	DEGREEPROGRAM
VISUAL ART DEGREE	DEGREEPROGRAM
4 YEAR DEGREE	EDUDEGREE
ACCOUNTING CERTIFICATION	EDUDEGREE
ADVANCED DEGREE	EDUDEGREE
B.A. 	EDUDEGREE
B.A. OR B.S.	EDUDEGREE
B.A. OR B.S. DEGREE	EDUDEGREE
B.A/B.S. DEGREE	EDUDEGREE
B.S. 	EDUDEGREE
BA DEGREE	EDUDEGREE
BA OR BS DEGREE	EDUDEGREE
BA/BS	EDUDEGREE
BA/BS DEGREE	EDUDEGREE
BA\BS	EDUDEGREE
BA\BS DEGREE	EDUDEGREE
BACCALAUREATE	EDUDEGREE
BACCALAUREATE DEGREE	EDUDEGREE
BACHELOR DEGREE	EDUDEGREE
BACHELOR LEVEL DEGREE	EDUDEGREE
BACHELOR OF	EDUDEGREE
BACHELOR OF ARTS	EDUDEGREE
BACHELOR OF COMMERCE	EDUDEGREE
BACHELOR OF LAW	EDUDEGREE
BACHELOR OF SCIENCE	EDUDEGREE
BACHELOR 'S	EDUDEGREE
BACHELOR 'S DEGREE	EDUDEGREE
BACHELOR 'S LEVEL DEGREE	EDUDEGREE
BACHELOR 'S OF SCIENCE	EDUDEGREE
BACHELORS	EDUDEGREE
BACHELOR'S	EDUDEGREE
BACHELORS DEGREE	EDUDEGREE
BACHELOR'S DEGREE	EDUDEGREE
BACHELORS LEVEL DEGREE	EDUDEGREE
BACHELOR'S LEVEL DEGREE	EDUDEGREE
BACHELOR'S OF SCIENCE	EDUDEGREE
BS DEGREE	EDUDEGREE
BS/BA	EDUDEGREE
BS/BA DEGREE	EDUDEGREE
BS\BA	EDUDEGREE
BS\BA DEGREE	EDUDEGREE
BSC	EDUDEGREE
CHEMISTRY	EDUDEGREE
COLLEGE DEGREE	EDUDEGREE
COMPLETION OF DEGREE	EDUDEGREE
CPA	EDUDEGREE
DEGREE 2 : 1	EDUDEGREE
DEGREE COMPLETION	EDUDEGREE
DEGREE DIPLOMA	EDUDEGREE
DEGREE EDUCATED	EDUDEGREE
DEGREE IN	EDUDEGREE
DEGREE LEVEL	EDUDEGREE
DEGREE LEVEL EDUCATION	EDUDEGREE
DEGREE OR EQUIVALENT	EDUDEGREE
DEGREE PREFERRED	EDUDEGREE
DEGREE QUALIFICATION	EDUDEGREE
DEGREE QUALIFICATIONS	EDUDEGREE
DEGREE QUALIFIED	EDUDEGREE
DEGREE STANDARD	EDUDEGREE
DOCTORAL DEGREE	EDUDEGREE
DOCTORATE	EDUDEGREE
DOCTORATE DEGREE	EDUDEGREE
EDUCATED TO DEGREE LEVEL	EDUDEGREE
ENGINEERING CERTIFICATION	EDUDEGREE
FOUR YEAR DEGREE	EDUDEGREE
GRADUATE DEGREE	EDUDEGREE
HIGHER DEGREE	EDUDEGREE
LIBERAL ARTS	EDUDEGREE
M.B.A	EDUDEGREE
M.B.A.	EDUDEGREE
MASTER DEGREE	EDUDEGREE
MASTER LEVEL DEGREE	EDUDEGREE
MASTER OF SCIENCE	EDUDEGREE
MASTER 'S	EDUDEGREE
MASTER 'S DEGREE	EDUDEGREE
MASTER 'S LEVEL DEGREE	EDUDEGREE
MASTERS	EDUDEGREE
MASTER'S	EDUDEGREE
MASTERS DEGREE	EDUDEGREE
MASTER'S DEGREE	EDUDEGREE
MASTERS LEVEL DEGREE	EDUDEGREE
MBA	EDUDEGREE
MSC	EDUDEGREE
P . ENG	EDUDEGREE
P.ENG	EDUDEGREE
PH . D	EDUDEGREE
PH.D	EDUDEGREE
PHD	EDUDEGREE
POST SECONDARY DEGREE	EDUDEGREE
POST-SECONDARY DEGREE	EDUDEGREE
POST-SECONDARY EDUCATION	EDUDEGREE
QUALIFICATION	EDUDEGREE
QUALIFICATIONS	EDUDEGREE
QUALIFYING DEGREE	EDUDEGREE
RELATED DEGREE	EDUDEGREE
RELEVANT TERTIARY QUALIFICATION	EDUDEGREE
TERTIARY	EDUDEGREE
TERTIARY DEGREE	EDUDEGREE
TERTIARY EDUCATION	EDUDEGREE
TERTIARY LEVEL	EDUDEGREE
TERTIARY QUALIFICATION	EDUDEGREE
TERTIARY QUALIFICATIONS	EDUDEGREE
UNDERGRADUATE DEGREE	EDUDEGREE
UNIVERSITY DEGREE	EDUDEGREE
CERTIFIED PUBLIC ACCOUNTANT	EDUDEGREE
DEGREE OR DIPLOMA	EDUDEGREE
DIPLOMA OR DEGREE	EDUDEGREE
ENTRY LEVEL	ENTRYLEVEL
ENTRY-LEVEL	ENTRYLEVEL
EXPERIENCE	EXPERIENCE
KNOWLEDGE	EXPERIENCE
"REPLACE(A428,1,1,UPPER(LEFT(A428,1)))"	function
ADD	IGNORESENTENCE
CANADIAN JOB	IGNORESENTENCE
READ WHAT	IGNORESENTENCE
ALLOW RECRUITERS	IGNORESENTENCE
APPLY	IGNORESENTENCE
ATTACH	IGNORESENTENCE
BACK	IGNORESENTENCE
BE THE FIRST	IGNORESENTENCE
CHECK THE STATUS	IGNORESENTENCE
CHECK YOUR	IGNORESENTENCE
CLICK	IGNORESENTENCE
CLOSING	IGNORESENTENCE
CONNECT WITH US	IGNORESENTENCE
CREATE	IGNORESENTENCE
CREATE AN ACCOUNT	IGNORESENTENCE
DO NOT	IGNORESENTENCE
DO YOU	IGNORESENTENCE
EMAIL	IGNORESENTENCE
ENTER	IGNORESENTENCE
FEEL	IGNORESENTENCE
FIND	IGNORESENTENCE
FOLLOW	IGNORESENTENCE
GET	IGNORESENTENCE
GET EMAIL	IGNORESENTENCE
GET FACTS ABOUT	IGNORESENTENCE
GET NEW	IGNORESENTENCE
GO BACK	IGNORESENTENCE
GO TO	IGNORESENTENCE
HELP US IMPROVE CAREERBUILDER	IGNORESENTENCE
HIGH SCHOOL DEGREE	IGNORESENTENCE
JOIN	IGNORESENTENCE
KEEP READING	IGNORESENTENCE
LEARN	IGNORESENTENCE
LET ' S	IGNORESENTENCE
LET EMPLOYERS	IGNORESENTENCE
LET EMPLOYER	IGNORESENTENCE
LET US	IGNORESENTENCE
LETS	IGNORESENTENCE
LOG IN	IGNORESENTENCE
LOGIN	IGNORESENTENCE
NOTE	IGNORESENTENCE
NOTIFY ME	IGNORESENTENCE
OPENING	IGNORESENTENCE
PLEASE	IGNORESENTENCE
POSTING	IGNORESENTENCE
POSTING DATE	IGNORESENTENCE
POSTING NOTES	IGNORESENTENCE
READ MORE	IGNORESENTENCE
REFER	IGNORESENTENCE
SAVE	IGNORESENTENCE
SEARCH ALL	IGNORESENTENCE
SEARCH FOR	IGNORESENTENCE
SEARCH JOBS	IGNORESENTENCE
SEE	IGNORESENTENCE
SEND	IGNORESENTENCE
SET A JOB ALERT	IGNORESENTENCE
SIGN IN	IGNORESENTENCE
SIGN UP	IGNORESENTENCE
SKIP	IGNORESENTENCE
SUBMIT	IGNORESENTENCE
THANK	IGNORESENTENCE
THANKS	IGNORESENTENCE
UNCHECKED	IGNORESENTENCE
UPDATE YOUR	IGNORESENTENCE
UPLOAD	IGNORESENTENCE
USE THE	IGNORESENTENCE
USE THE JOB LINKS	IGNORESENTENCE
VISIT	IGNORESENTENCE
WELCOME	IGNORESENTENCE
YOU WILL NEVER	IGNORESENTENCE
ADJUSTER	JOBCORE
ADMINISTRATOR	JOBCORE
ADVISOR	JOBCORE
ADVOCATE	JOBCORE
AIDE	JOBCORE
AMBASSADOR	JOBCORE
ANALYST	JOBCORE
ANTHROPOLOGIST	JOBCORE
APPRENTICE	JOBCORE
APPRENTICESHIP	JOBCORE
ARCHAEOLOGIST	JOBCORE
ARCHITECT	JOBCORE
ARTIST	JOBCORE
ASSESSOR	JOBCORE
ASSISTANT	JOBCORE
ASSOCIATE	JOBCORE
ASTRONOMER	JOBCORE
AUDIOLOGIST	JOBCORE
AUTHOR	JOBCORE
BARRISTER	JOBCORE
BEAUTICIAN	JOBCORE
BIOINFORMATICIAN	JOBCORE
BIOLOGIST	JOBCORE
BROKER	JOBCORE
BUYER	JOBCORE
CARPENTER	JOBCORE
CASHIER	JOBCORE
CHEMIST	JOBCORE
CHIROPRACTOR	JOBCORE
CLERK	JOBCORE
CLINICIAN	JOBCORE
CO - ORDINATOR	JOBCORE
COACH	JOBCORE
COMBINATION WELDER	JOBCORE
COMEDIAN	JOBCORE
COMPTROLLER	JOBCORE
CONSULTANT	JOBCORE
CONTRACTOR	JOBCORE
COORD	JOBCORE
COORDINATOR	JOBCORE
CO-ORDINATOR	JOBCORE
COPYWRITER	JOBCORE
COUNSELOR	JOBCORE
COURIER	JOBCORE
CREATOR	JOBCORE
CURATOR	JOBCORE
DANCER	JOBCORE
DEAN	JOBCORE
DENTIST	JOBCORE
DESIGNER	JOBCORE
DEVELOPER	JOBCORE
DIRECTOR	JOBCORE
DOCTOR	JOBCORE
DRIVER	JOBCORE
ECONOMIST	JOBCORE
EDUCATOR	JOBCORE
ENGINEER	JOBCORE
ENVIRONMENTALIST	JOBCORE
EPIDEMIOLOGIST	JOBCORE
EXAMINER	JOBCORE
EXECUTIVE	JOBCORE
FACILITATOR	JOBCORE
FACILITIES TECHNICIAN	JOBCORE
FACULTY	JOBCORE
FARMER	JOBCORE
FELLOW	JOBCORE
FIREFIGHTER	JOBCORE
GENERALIST	JOBCORE
GEOGRAPHER	JOBCORE
GEOLOGIST	JOBCORE
GRAMMARIAN	JOBCORE
GRAVEDIGGER	JOBCORE
GROCER	JOBCORE
GUARDIAN	JOBCORE
GUITARIST	JOBCORE
HISTORIAN	JOBCORE
HOSTESS	JOBCORE
HOUSEKEEPER	JOBCORE
HYDROLOGIST	JOBCORE
INSPECTOR	JOBCORE
INSTRUCTOR	JOBCORE
INTERN	JOBCORE
INVESTIGATOR	JOBCORE
JEWELER	JOBCORE
JOURNALIST	JOBCORE
KINESIOLOGIST	JOBCORE
LAWYER	JOBCORE
LEAD	JOBCORE
LIAISON	JOBCORE
LIBRARIAN	JOBCORE
LINGUIST	JOBCORE
LOBBYIST	JOBCORE
MAGICIAN	JOBCORE
MANAGER	JOBCORE
MATHEMATICIAN	JOBCORE
MECHANIC	JOBCORE
MERCHANDISER	JOBCORE
MICROBIOLOGIST	JOBCORE
MODEL	JOBCORE
MONITOR	JOBCORE
MUSICIAN	JOBCORE
NOVELIST	JOBCORE
NURSE	JOBCORE
NUTRITIONIST	JOBCORE
OBSTETRICIAN	JOBCORE
OFFICER	JOBCORE
OPERATOR	JOBCORE
OPTOMETRIST	JOBCORE
ORTHODONTIST	JOBCORE
PA	JOBCORE
PAINTER	JOBCORE
PARALEGAL	JOBCORE
PEDIATRICIAN	JOBCORE
PHARMACIST	JOBCORE
PHILANTHROPIST	JOBCORE
PHILOSOPHER	JOBCORE
PHYSICIAN	JOBCORE
PHYSICIST	JOBCORE
PHYSIOTHERAPIST	JOBCORE
PIANIST	JOBCORE
PLANNER	JOBCORE
PODIATRIST	JOBCORE
POLITICIAN	JOBCORE
PRACTITIONER	JOBCORE
PRODUCER	JOBCORE
PROFESSOR	JOBCORE
PROGRAMMER	JOBCORE
PSYCHIATRIST	JOBCORE
PSYCHOLOGIST	JOBCORE
RACIST	JOBCORE
RADIOGRAPHER	JOBCORE
RECEPTIONIST	JOBCORE
RECRUITER	JOBCORE
REPRESENTATIVE	JOBCORE
RESEARCHER	JOBCORE
RESTAURATEUR	JOBCORE
RETAILER	JOBCORE
REVIEWER	JOBCORE
RHETORICIAN	JOBCORE
SCIENTIST	JOBCORE
SENATOR	JOBCORE
SOCIOLOGIST	JOBCORE
SPECIALIST	JOBCORE
STATISTICIAN	JOBCORE
SUPERVISOR	JOBCORE
SURGEON	JOBCORE
SURVEYOR	JOBCORE
TEACHER	JOBCORE
TECHNICIAN	JOBCORE
TECHNOLOGIST	JOBCORE
THERAPIST	JOBCORE
TRADER	JOBCORE
TRAINEE	JOBCORE
TRAINER	JOBCORE
TRANSLATOR	JOBCORE
TREASURER	JOBCORE
TUTOR	JOBCORE
UNDERWRITER	JOBCORE
VETERINARIAN	JOBCORE
WORKER	JOBCORE
WRITER	JOBCORE
1ST GRADE TEACHER	JOBTITLE
ABA THERAPIST	JOBTITLE
ACADEMIC COORDINATOR	JOBTITLE
ACADEMIC INTERNSHIP SPECIALIST	JOBTITLE
ACCESS REPRESENTATIVE	JOBTITLE
ACCESS SERVICES MANAGER	JOBTITLE
ACCESS SPECIALIST	JOBTITLE
ACCOUNT ADMINISTRATOR	JOBTITLE
ACCOUNT ASSOCIATE	JOBTITLE
ACCOUNT COORDINATOR	JOBTITLE
ACCOUNT DIRECTOR	JOBTITLE
ACCOUNT EXECUTIVE	JOBTITLE
ACCOUNT EXECUTIVE MANAGER	JOBTITLE
ACCOUNT MANAGER	JOBTITLE
ACCOUNT REPRESENTATIVE	JOBTITLE
ACCOUNTANT	JOBTITLE
ACCOUNTING ASSOCIATE	JOBTITLE
ACCOUNTING CLERK	JOBTITLE
ACCOUNTING MANAGER	JOBTITLE
ACCOUNTING SPECIALIST	JOBTITLE
ACCOUNTING TECHNICIAN	JOBTITLE
ACCOUNTS PAYABLE ANALYST	JOBTITLE
ACCOUNTS PAYABLE CLERK	JOBTITLE
ACCOUNTS PAYABLE MANAGER	JOBTITLE
ACCOUNTS PAYABLE SPECIALIST	JOBTITLE
ACCOUNTS RECEIVABLE ASSOCIATE	JOBTITLE
ACCOUNTS RECEIVABLE CLERK	JOBTITLE
ACCOUNTS RECEIVABLE SPECIALIST	JOBTITLE
ACCREDITATION MANAGER	JOBTITLE
ACQUISITION MANAGER	JOBTITLE
ACQUISITION SPECIALIST	JOBTITLE
ACTIVITIES ASSISTANT	JOBTITLE
ACTIVITIES COORDINATOR	JOBTITLE
ACTIVITIES DIRECTOR	JOBTITLE
ACUTE CARE NURSE	JOBTITLE
ADAMS ANALYST	JOBTITLE
ADDICTION CENTER MANAGER	JOBTITLE
ADJUNCT FACULTY	JOBTITLE
ADJUSTER TRAINEE	JOBTITLE
ADMIN ASSISTANT	JOBTITLE
ADMINISTRATION MANAGER	JOBTITLE
ADMINISTRATIVE ANALYST	JOBTITLE
ADMINISTRATIVE ASSISTANT	JOBTITLE
ADMINISTRATIVE ASSOCIATE	JOBTITLE
ADMINISTRATIVE COORDINATOR	JOBTITLE
ADMINISTRATIVE RECEPTIONIST	JOBTITLE
ADMINISTRATIVE SPECIALIST 	JOBTITLE
ADMINISTRATIVE SUPERVISOR	JOBTITLE
ADMINISTRATIVE SUPPORT COORDINATOR	JOBTITLE
ADMINISTRATIVE TECHNICIAN	JOBTITLE
ADMISSIONS COORDINATOR	JOBTITLE
ADMISSIONS COUNSELOR	JOBTITLE
ADMISSIONS OFFICER	JOBTITLE
ADMISSIONS REPRESENTATIVE	JOBTITLE
ADMISSIONS SPECIALIST	JOBTITLE
ADVANCED DANCE FACULTY	JOBTITLE
ADVANCED MEDICAL SUPPORT ASSISTANT	JOBTITLE
ADVANCED NURSE	JOBTITLE
ADVANCED PRACTITIONER	JOBTITLE
AESTHETICIAN COSMETOLOGIST	JOBTITLE
AGENCY REPRESENTATIVE	JOBTITLE
AIR DUCT CLEANING TECHNICIAN	JOBTITLE
AIRFRAME & POWERPLANT SUPERVISOR	JOBTITLE
AIRPORT AND FERRY ADMINISTRATOR	JOBTITLE
AIRPORT MANAGER	JOBTITLE
AIT ENGINEER	JOBTITLE
ALIAS MODELLER	JOBTITLE
ANALYSIS THERAPIST	JOBTITLE
ANALYST - CUSTOMER CARE 	JOBTITLE
ANALYST ETL SPECIALIST	JOBTITLE
ANALYST FOR MANAGED CARE	JOBTITLE
ANALYST IN	JOBTITLE
ANALYST OR ASSOCIATE	JOBTITLE
ANALYST SUPERVISOR	JOBTITLE
ANALYST/PROJECT MANAGER	JOBTITLE
ANESTHESIA TECHNICIAN	JOBTITLE
APARTMENT MAINTENANCE SUPERVISOR	JOBTITLE
APPLIANCES MANAGER	JOBTITLE
APPLICATION ADMINISTRATOR	JOBTITLE
APPLICATION ANALYST	JOBTITLE
APPLICATION DEVELOPER	JOBTITLE
APPLICATION SPECIALIST	JOBTITLE
APPLICATION SUPPORT ENGINEER	JOBTITLE
APPLICATIONS ADMINISTRATOR	JOBTITLE
APPLICATIONS ANALYST	JOBTITLE
APPLICATIONS DEVELOPER	JOBTITLE
APPLICATIONS ENGINEER	JOBTITLE
APPLICATIONS SPECIALIST	JOBTITLE
APPLICATOR LICENSE	JOBTITLE
APPLIED BEHAVIOR ANALYSIS THERAPIST	JOBTITLE
APPLIED BEHAVIOR ANALYSIS TUTOR	JOBTITLE
AQUATICS INSTRUCTOR	JOBTITLE
ARCHAEOLOGICAL FIELD TECHNICIAN 	JOBTITLE
ARCHITECTURE CONSULTANT	JOBTITLE
AREA MANAGER	JOBTITLE
ART DIRECTOR	JOBTITLE
ART TEACHER	JOBTITLE
ARTS TEACHER	JOBTITLE
ASP PROGRAMMER	JOBTITLE
ASSESSMENT & REFERRAL SPECIALIST	JOBTITLE
ASSESSMENT COORDINATOR	JOBTITLE
ASSET MANAGER	JOBTITLE
ASSET PROTECTION ASSOCIATE	JOBTITLE
ASSISTANT ACCOUNT EXECUTIVE	JOBTITLE
ASSISTANT ACCOUNT MANAGER	JOBTITLE
ASSISTANT ANALYST	JOBTITLE
ASSISTANT BRANCH MANAGER	JOBTITLE
ASSISTANT BRAND MANAGER	JOBTITLE
ASSISTANT BUSINESS ASSISTANT	JOBTITLE
ASSISTANT BUYER	JOBTITLE
ASSISTANT CAMPUS COORDINATOR	JOBTITLE
ASSISTANT CONTROLLER	JOBTITLE
ASSISTANT COORDINATOR COMMUNITY CONNECTIONS	JOBTITLE
ASSISTANT CUSTOMER SERVICE REPRESENTATIVE	JOBTITLE
ASSISTANT DEAN	JOBTITLE
ASSISTANT DEPARTMENT ADMINISTRATOR	JOBTITLE
ASSISTANT DIRECTOR	JOBTITLE
ASSISTANT ENVIRONMENTAL SERVICES DIRECTOR	JOBTITLE
ASSISTANT EVENING SUPERVISOR	JOBTITLE
ASSISTANT FITNESS MANAGER	JOBTITLE
ASSISTANT FRONT OFFICE MANAGER	JOBTITLE
ASSISTANT GENERAL MANAGER	JOBTITLE
ASSISTANT GENERAL MANAGER AGM	JOBTITLE
ASSISTANT LABORATORY MANAGER	JOBTITLE
ASSISTANT LEGAL CLAIMS EXAMINER	JOBTITLE
ASSISTANT MANAGER	JOBTITLE
ASSISTANT MANAGER ACCOUNT	JOBTITLE
ASSISTANT MANAGER ACCOUNT ACTIVATION	JOBTITLE
ASSISTANT MARKETING MANAGER	JOBTITLE
ASSISTANT MEDIA PLANNER	JOBTITLE
ASSISTANT MERCHANDISING MANAGER	JOBTITLE
ASSISTANT OPERATIONS MANAGER	JOBTITLE
ASSISTANT OUTLET MANAGER	JOBTITLE
ASSISTANT OUTLET MANAGER SEASONAL	JOBTITLE
ASSISTANT PLANNER	JOBTITLE
ASSISTANT PRINCIPAL	JOBTITLE
ASSISTANT PRODUCT MANAGER	JOBTITLE
ASSISTANT PRODUCTION SUPERVISOR	JOBTITLE
ASSISTANT PROFESSOR	JOBTITLE
ASSISTANT PROGRAM DIRECTOR	JOBTITLE
ASSISTANT PROGRAM MANAGER	JOBTITLE
ASSISTANT PROGRAM OFFICER	JOBTITLE
ASSISTANT PROJECT MANAGER	JOBTITLE
ASSISTANT PROPERTY MANAGER	JOBTITLE
ASSISTANT QUALITY CONTROL MANAGER	JOBTITLE
ASSISTANT RESTAURANT MANAGER	JOBTITLE
ASSISTANT RETAIL STORE MANAGER	JOBTITLE
ASSISTANT SALES MANAGER	JOBTITLE
ASSISTANT SERVICE MANAGER	JOBTITLE
ASSISTANT STORE MANAGER	JOBTITLE
ASSISTANT STORE MANAGER SALARY	JOBTITLE
ASSISTANT STUDIO MANAGER	JOBTITLE
ASSISTANT SUPERINTENDENT	JOBTITLE
ASSISTANT SUPERVISOR	JOBTITLE
ASSISTANT TEACHER	JOBTITLE
ASSISTANT TEAM MANAGER	JOBTITLE
ASSISTANT TO EXECUTIVE DIRECTOR	JOBTITLE
ASSISTANT VICE PRESIDENT	JOBTITLE
ASSISTANT/OFFICE COORDINATOR	JOBTITLE
ASSOCIATE ACCOUNTANT 	JOBTITLE
ASSOCIATE ADMINISTRATOR	JOBTITLE
ASSOCIATE ANALYST	JOBTITLE
ASSOCIATE CATEGORY/BRAND MANAGER	JOBTITLE
ASSOCIATE CDA	JOBTITLE
ASSOCIATE CLAIMS SPECIALIST	JOBTITLE
ASSOCIATE CONSULTANT	JOBTITLE
ASSOCIATE CREATIVE DIRECTOR	JOBTITLE
ASSOCIATE DEAN	JOBTITLE
ASSOCIATE DIRECTOR	JOBTITLE
ASSOCIATE MANAGER	JOBTITLE
ASSOCIATE MEDICAL DIRECTOR	JOBTITLE
ASSOCIATE PLANNER	JOBTITLE
ASSOCIATE PRODUCER	JOBTITLE
ASSOCIATE PROGRAM DIRECTOR	JOBTITLE
ASSOCIATE PROJECT MANAGER	JOBTITLE
ASSOCIATE SALES	JOBTITLE
ASSOCIATE SCIENTIST	JOBTITLE
ASSOCIATE SOURCING MANAGER	JOBTITLE
ASSOCIATE TEACHER	JOBTITLE
ASSOCIATE VICE PRESIDENT	JOBTITLE
ASSOCIATE WEALTH MANAGEMENT	JOBTITLE
ASSOCIATE WEALTH MANAGEMENT ADVISOR	JOBTITLE
ASSOCIATE WORKSHOP MANAGER	JOBTITLE
ASSURANCE ANALYST	JOBTITLE
ASSURANCE MANAGER	JOBTITLE
ASSURANCE OFFICER	JOBTITLE
ASSURANCE SPECIALIST	JOBTITLE
ATHLETIC DIRECTOR	JOBTITLE
ATHLETIC TRAINER	JOBTITLE
ATHLETIC TRAINERS	JOBTITLE
ATTENDANCE COORDINATOR	JOBTITLE
AUDIT ANALYST	JOBTITLE
AUDIT ASSOCIATE	JOBTITLE
AUDIT MANAGER	JOBTITLE
AUDITOR	JOBTITLE
AUTISM TEACHER 	JOBTITLE
AUTO DAMAGE ADJUSTER	JOBTITLE
AUTO DAMAGE TRAINEE	JOBTITLE
AUTOMOTIVE SERVICE MANAGER	JOBTITLE
AUTOMOTIVE TECHNICIAN	JOBTITLE
AVIONICS TECHNICIAN	JOBTITLE
AVMA ASSOCIATE	JOBTITLE
BACHELOR OF SCIENCE - BSC - MASTER OF SCIENCE - MSC - DOCTOR	JOBTITLE
BARISTA	JOBTITLE
BCBA MANAGER	JOBTITLE
BEAUTY ADVISOR	JOBTITLE
BEHAVIOR ANALYSIS THERAPIST	JOBTITLE
BEHAVIOR ANALYST	JOBTITLE
BEHAVIOR MODIFICATION ASSISTANT	JOBTITLE
BEHAVIOR SPECIALIST	JOBTITLE
BEHAVIORAL HEALTH TECHNICIAN	JOBTITLE
BEHAVIOURAL CONSULTANT	JOBTITLE
BENEFIT CONSULTANT	JOBTITLE
BENEFIT SPECIALIST	JOBTITLE
BENEFITS & HR OPERATIONS ANALYST	JOBTITLE
BENEFITS COORDINATOR	JOBTITLE
BENEFITS MANAGER	JOBTITLE
BENEFITS SPECIALIST	JOBTITLE
BENEFITS/PRECERT COORDINATOR	JOBTITLE
BEVERAGE MANAGER	JOBTITLE
BID MANAGER	JOBTITLE
BIG DATA INNOVATION MANAGER	JOBTITLE
BILINGUAL RECEPTIONIST	JOBTITLE
BILINGUAL TEACHER	JOBTITLE
BILINGUAL TEACHER AIDE	JOBTITLE
BILLING ANALYST 	JOBTITLE
BILLING AND CODING SPECIALIST 	JOBTITLE
BILLING COORDINATOR	JOBTITLE
BILLING SPECIALIST	JOBTITLE
BINDERY OPERATOR	JOBTITLE
BIODIVERSITY OFFICER	JOBTITLE
BIOLOGIST TECHNICIAN	JOBTITLE
BIOMED TECHNICIAN	JOBTITLE
BLACKROCK TELECOMMUNICATIONS IPT ADMINISTRATOR	JOBTITLE
BLS INSTRUCTOR	JOBTITLE
BOARD CERTIFIED BEHAVIOR ANALYST	JOBTITLE
BOAT MECHANIC	JOBTITLE
BRANCH MANAGER	JOBTITLE
BRANCH SERVICE MANAGER	JOBTITLE
BRAND MANAGER	JOBTITLE
BRICKLAYER	JOBTITLE
BROKER TEST ANALYST	JOBTITLE
BUDGET ANALYST	JOBTITLE
BUDGET OFFICER	JOBTITLE
BUILDING MANAGER	JOBTITLE
BUILDING PLANS EXAMINER	JOBTITLE
BUS CLEANER	JOBTITLE
BUSINESS ANALYST	JOBTITLE
BUSINESS ANALYST 	JOBTITLE
BUSINESS CONSULTANT	JOBTITLE
BUSINESS DEVELOPMENT ASSOCIATE	JOBTITLE
BUSINESS DEVELOPMENT DIRECTOR	JOBTITLE
BUSINESS DEVELOPMENT EXECUTIVE	JOBTITLE
BUSINESS DEVELOPMENT MANAGER	JOBTITLE
BUSINESS DEVELOPMENT OFFICER	JOBTITLE
BUSINESS DEVELOPMENT REPRESENTATIVE	JOBTITLE
BUSINESS DEVELOPMENT SPECIALIST	JOBTITLE
BUSINESS INTEGRATION SPECIALIST 	JOBTITLE
BUSINESS INTELLIGENCE SPECIALIST	JOBTITLE
BUSINESS MANAGER	JOBTITLE
BUSINESS OPERATIONS ANALYST	JOBTITLE
BUSINESS SERVICES AND OUTSOURCING ASSOCIATE	JOBTITLE
BUSINESS SYSTEM ANALYST	JOBTITLE
BUSINESS SYSTEMS ANALYST	JOBTITLE
BUSINESS UNIT MANAGER	JOBTITLE
BUSINESS/DATA ANALYST	JOBTITLE
BUTCHER	JOBTITLE
BUYER SOURCING SPECIALIST	JOBTITLE
C C++ DEVELOPER	JOBTITLE
C++ DEVELOPER	JOBTITLE
CAD TECHNICIAN	JOBTITLE
CAE ANALYST	JOBTITLE
CALL CENTER REPRESENTATIVE	JOBTITLE
CAMP DIRECTOR	JOBTITLE
CAMP NURSE	JOBTITLE
CAMPAIGN MANAGER	JOBTITLE
CAPACITY COORDINATOR	JOBTITLE
CAPITA SPECIALIST	JOBTITLE
CARDIAC DEVICE TECHNICIAN	JOBTITLE
CARDIAC MONITOR	JOBTITLE
CARDIOVASCULAR TECHNICIAN	JOBTITLE
CARE ASSISTANT	JOBTITLE
CARE COORDINATOR	JOBTITLE
CARE PROJECT MANAGER	JOBTITLE
CARE SERVICES DIRECTOR	JOBTITLE
CARE SERVICES MANAGER	JOBTITLE
CARE SPECIALIST	JOBTITLE
CARE TECH ASSOCIATE	JOBTITLE
CARPENTERS HANDYMAN	JOBTITLE
CART REPORTER	JOBTITLE
CASE MANAGER	JOBTITLE
CASE MANAGER 	JOBTITLE
CASE WORKER	JOBTITLE
CASH POSTING SPECIALIST	JOBTITLE
CASHIER CLERK	JOBTITLE
CATEGORY MANAGER	JOBTITLE
CATEGORY SPECIALIST	JOBTITLE
CATERING COORDINATOR	JOBTITLE
CATERING MANAGER	JOBTITLE
CENTER ADMINISTRATOR	JOBTITLE
CENTER DIRECTOR	JOBTITLE
CENTER MANAGER	JOBTITLE
CENTER OPERATIONS DIRECTOR	JOBTITLE
CENTER REPRESENTATIVE	JOBTITLE
CENTER STORAGE MANAGER	JOBTITLE
CENTER SUPERVISOR	JOBTITLE
CENTRAL SUPPLY CLERK	JOBTITLE
CHANGE MANAGEMENT LEAD	JOBTITLE
CHANNEL PARTNER MANAGER	JOBTITLE
CHARGE NURSE	JOBTITLE
CHARTER SCHEDULING SPECIALIST	JOBTITLE
CHARTERED ENGINEER	JOBTITLE
CHIEF	JOBTITLE
CHIEF BUSINESS OFFICER	JOBTITLE
CHIEF CUSTOMER EXPERIENCE LEAD	JOBTITLE
CHIEF EXECUTIVE	JOBTITLE
CHIEF FINANCIAL	JOBTITLE
CHIEF FINANCIAL OFFICER	JOBTITLE
CHIEF INFORMATION OFFICER	JOBTITLE
CHIEF OFFICER	JOBTITLE
CHILD CARE ASSISTANT	JOBTITLE
CHILD CARE PROGRAMS SPECIALIST	JOBTITLE
CHILD CARE SPECIALIST	JOBTITLE
CHILD DEVELOPMENT SITE SUPERVISOR	JOBTITLE
CHILD DEVELOPMENT SPECIALIST	JOBTITLE
CHILD DEVELOPMENT TEACHER	JOBTITLE
CHILD WELFARE SPECIALIST	JOBTITLE
CHILDHOOD DEVELOPMENT ASSOCIATE	JOBTITLE
CHILDHOOD EDUCATOR	JOBTITLE
CHILDHOOD SPECIALIST	JOBTITLE
CISCO GRADUATE AND INTERN	JOBTITLE
CLAIMS ADJUSTER	JOBTITLE
CLAIMS EXAMINER	JOBTITLE
CLAIMS REPRESENTATIVE	JOBTITLE
CLAIMS SPECIALIST	JOBTITLE
CLASS INSTRUCTOR	JOBTITLE
CLASSIFICATION : ACCOUNTANT	JOBTITLE
CLASSROOM ASSISTANT	JOBTITLE
CLASSROOM INSTRUCTOR	JOBTITLE
CLASSROOM TEACHER	JOBTITLE
CLERK CASHIER	JOBTITLE
CLIENT ADVOCATE	JOBTITLE
CLIENT RELATIONS AND MARKETING COORDINATOR	JOBTITLE
CLIENT RELATIONSHIP MANAGER	JOBTITLE
CLIENT REPRESENTATIVE	JOBTITLE
CLIENT SERVICE ACCOUNT MANAGER	JOBTITLE
CLIENT SERVICE ANALYST	JOBTITLE
CLIENT SERVICE ASSISTANT	JOBTITLE
CLIENT SERVICE ASSOCIATE	JOBTITLE
CLIENT SERVICE COORDINATOR	JOBTITLE
CLIENT SERVICE DELIVERY MANAGER	JOBTITLE
CLIENT SERVICE DESK ANALYST	JOBTITLE
CLIENT SERVICE DESK TECHNICIAN	JOBTITLE
CLIENT SERVICE DIRECTOR	JOBTITLE
CLIENT SERVICE GUIDE	JOBTITLE
CLIENT SERVICE MANAGER	JOBTITLE
CLIENT SERVICE REPRESENTATIVE	JOBTITLE
CLIENT SERVICE SALES REPRESENTATIVE	JOBTITLE
CLIENT SERVICE SPECIALIST	JOBTITLE
CLIENT SERVICE SUPERVISOR	JOBTITLE
CLIENT SERVICE TECHNICIAN	JOBTITLE
CLIENT SERVICES ADMINISTRATOR	JOBTITLE
CLIENT SERVICES ASSISTANT	JOBTITLE
CLIENT SERVICES ASSOCIATE	JOBTITLE
CLIENT SERVICES COORDINATOR	JOBTITLE
CLIENT SERVICES DIRECTOR	JOBTITLE
CLIENT SERVICES MANAGER	JOBTITLE
CLIENT SERVICES REPRESENTATIVE	JOBTITLE
CLIENT SERVICES SPECIALIST	JOBTITLE
CLIENT SERVICES SUPERVISOR	JOBTITLE
CLIENT SERVICES TECHNICIAN	JOBTITLE
CLIENT SOLUTIONS MANAGER	JOBTITLE
CLIENT SUCCESS MANAGER	JOBTITLE
CLIENT TECHNOLOGY SERVICES MANAGER	JOBTITLE
CLINCIAL RESEARCH PROFESSIONAL	JOBTITLE
CLINIC MANAGER	JOBTITLE
CLINIC SUPERVISOR	JOBTITLE
CLINICAL ASSISTANT	JOBTITLE
CLINICAL CARE COORDINATOR	JOBTITLE
CLINICAL CARE TRANSITION SPECIALIST	JOBTITLE
CLINICAL COORDINATOR 	JOBTITLE
CLINICAL DIRECTOR 	JOBTITLE
CLINICAL ENGINEER	JOBTITLE
CLINICAL LAB SCIENTIST	JOBTITLE
CLINICAL LABORATORY SCIENTIST	JOBTITLE
CLINICAL LIAISON	JOBTITLE
CLINICAL MANAGER	JOBTITLE
CLINICAL MEDICAL ASSISTANT	JOBTITLE
CLINICAL NURSE	JOBTITLE
CLINICAL RESEARCH ASSISTANT	JOBTITLE
CLINICAL RESEARCH ASSOCIATE	JOBTITLE
CLINICAL RESEARCH COORD	JOBTITLE
CLINICAL RESEARCH PHYSICIAN	JOBTITLE
CLINICAL SPECIALIST	JOBTITLE
CLINICAL STAFF NURSE	JOBTITLE
CLINICAL SUPERVISOR	JOBTITLE
CLINICAL THERAPIST	JOBTITLE
CLINICAL TRANSPLANT COORDINATOR	JOBTITLE
CLUB MANAGER	JOBTITLE
CNA RESTORATIVE AIDE	JOBTITLE
CNC SPECIALIST	JOBTITLE
COACH/EMPLOYMENT SPECIALIST	JOBTITLE
COACHING SUPERVISOR	JOBTITLE
CODING ASSISTANT	JOBTITLE
CODING SPECIALIST	JOBTITLE
COLLECTIONS ACCOUNTANT	JOBTITLE
COLLECTIONS ANALYST	JOBTITLE
COLLECTIONS REPRESENTATIVE	JOBTITLE
COLLECTIONS SPECIALIST	JOBTITLE
COMMANDING OFFICER	JOBTITLE
COMMERCIAL DIRECTOR	JOBTITLE
COMMERCIAL LINES ACCOUNT MANAGER TRAINEE	JOBTITLE
COMMERCIAL LINES RETENTION REPRESENTATIVE	JOBTITLE
COMMERCIAL MANAGER	JOBTITLE
COMMUNICATION & SERVICES TECHNOLOGY LEAD	JOBTITLE
COMMUNICATIONS COORDINATOR	JOBTITLE
COMMUNICATIONS DIRECTOR	JOBTITLE
COMMUNICATIONS MANAGER	JOBTITLE
COMMUNICATIONS OFFICER	JOBTITLE
COMMUNICATIONS SPECIALIST	JOBTITLE
COMMUNITY ASSOCIATION MANAGER	JOBTITLE
COMMUNITY HEALTH CARE WORKER	JOBTITLE
COMMUNITY HEALTH WORKER	JOBTITLE
COMMUNITY LIAISON	JOBTITLE
COMMUNITY MANAGER	JOBTITLE
COMMUNITY PARAMEDIC	JOBTITLE
COMMUNITY RELATIONS MANAGER	JOBTITLE
COMMUNITY RELATIONS SPECIALIST	JOBTITLE
COMMUNITY SALES ASSISTANT	JOBTITLE
COMMUNITY SERVICE OFFICER	JOBTITLE
COMPENSATION ANALYST	JOBTITLE
COMPENSATION SPECIALIST	JOBTITLE
COMPLEX NEEDS SPECIALIST	JOBTITLE
COMPLIANCE & SECURITY MANAGER	JOBTITLE
COMPLIANCE ANALYST	JOBTITLE
COMPLIANCE ANALYST 	JOBTITLE
COMPLIANCE ASSOCIATE	JOBTITLE
COMPLIANCE MANAGER	JOBTITLE
COMPLIANCE MANAGER 	JOBTITLE
COMPLIANCE OFFICER	JOBTITLE
COMPLIANCE SPECIALIST	JOBTITLE
COMPOUNDING PHARMACIST	JOBTITLE
COMPOUNDING TECHNICIAN	JOBTITLE
COMPUTER AND INFORMATION SCIENCES SYSTEMS ANALYST	JOBTITLE
COMPUTER NUMERIC CONTROL TECHNICIAN	JOBTITLE
COMPUTER TECHNICIAN	JOBTITLE
COMPUTERIZED TOMOGRAPHY RADIOLOGY TECHNOLOGIST	JOBTITLE
CONFIGURATION ANALYST	JOBTITLE
CONSTRUCTION MANAGER	JOBTITLE
CONSTRUCTION PROJECT MANAGER	JOBTITLE
CONSTRUCTION WORKER	JOBTITLE
CONSULTANT MANAGER	JOBTITLE
CONTENT AREA SPECIALIST	JOBTITLE
CONTENT CREATOR	JOBTITLE
CONTENT MANAGER	JOBTITLE
CONTENT STRATEGY MANAGER	JOBTITLE
CONTINUOUS IMPROVEMENT DIRECTOR	JOBTITLE
CONTRACT & PROCUREMENT SPECIALIST	JOBTITLE
CONTRACT ADMINISTRATOR	JOBTITLE
CONTRACT ANALYST	JOBTITLE
CONTRACT COORDINATOR	JOBTITLE
CONTRACT MANAGER	JOBTITLE
CONTRACT NURSE	JOBTITLE
CONTRACT OFFICER	JOBTITLE
CONTRACT SPECIALIST	JOBTITLE
CONTRACTS ADMINISTRATOR	JOBTITLE
CONTRACTS DIRECTOR	JOBTITLE
CONTRACTS MANAGER	JOBTITLE
CONTRACTS SPECIALIST	JOBTITLE
CONTROL ADMINISTRATOR	JOBTITLE
CONTROL ANALYST	JOBTITLE
CONTROL MANAGER	JOBTITLE
CONTROL SPECIALIST	JOBTITLE
CONTROL SYSTEM TECHNICIAN	JOBTITLE
CONTROL TECHNICIAN	JOBTITLE
CONTROLLER	JOBTITLE
CONTROLS SPECIALIST	JOBTITLE
COORDINATOR OF CARE	JOBTITLE
COORDINATOR OF CARE SERVICES	JOBTITLE
COORDINATOR SPECIALIST	JOBTITLE
CORPORATE ENGAGEMENT MANAGER 	JOBTITLE
CORPORATE FINANCE MANAGER	JOBTITLE
CORPORATE PARALEGAL	JOBTITLE
CORRECTIONAL OFFICER	JOBTITLE
COSMETOLOGIST	JOBTITLE
COST ACCOUNTANT	JOBTITLE
COST ANALYST	JOBTITLE
COST CONTROL ANALYST	JOBTITLE
COUNSELING AIDE	JOBTITLE
COUNTER REPRESENTATIVE	JOBTITLE
CPE SUPERVISOR	JOBTITLE
CPS TEACHER	JOBTITLE
CREATIVE DIRECTOR	JOBTITLE
CREATIVE DOCUMENT SPECIALIST	JOBTITLE
CREDENTIALING SPECIALIST	JOBTITLE
CREW SUPERVISOR	JOBTITLE
CRISIS INTERVENTION SPECIALIST	JOBTITLE
CT TECHNOLOGIST	JOBTITLE
CUSTOM PROTECTION OFFICER	JOBTITLE
CUSTOMER ASSOCIATE	JOBTITLE
CUSTOMER CARE ANALYST	JOBTITLE
CUSTOMER CARE REPRESENTATIVE	JOBTITLE
CUSTOMER CARE SPECIALIST	JOBTITLE
CUSTOMER EXPERIENCE ASSOCIATE	JOBTITLE
CUSTOMER EXPERIENCE LEAD	JOBTITLE
CUSTOMER EXPERIENCE MANAGER	JOBTITLE
CUSTOMER EXPERIENCE REPRESENTATIVE	JOBTITLE
CUSTOMER EXPERIENCE SUPERVISOR	JOBTITLE
CUSTOMER MANAGER 	JOBTITLE
CUSTOMER RELATIONS REPRESENTATIVE	JOBTITLE
CUSTOMER SERVICE ACCOUNT MANAGER	JOBTITLE
CUSTOMER SERVICE ADMINISTRATOR	JOBTITLE
CUSTOMER SERVICE ANALYST	JOBTITLE
CUSTOMER SERVICE ASSISTANT	JOBTITLE
CUSTOMER SERVICE ASSOCIATE	JOBTITLE
CUSTOMER SERVICE CALL CENTER REPRESENTATIVE	JOBTITLE
CUSTOMER SERVICE CONSULTANT	JOBTITLE
CUSTOMER SERVICE COORDINATOR	JOBTITLE
CUSTOMER SERVICE DELIVERY MANAGER	JOBTITLE
CUSTOMER SERVICE DESK ANALYST	JOBTITLE
CUSTOMER SERVICE DESK TECHNICIAN	JOBTITLE
CUSTOMER SERVICE DIRECTOR	JOBTITLE
CUSTOMER SERVICE GUIDE	JOBTITLE
CUSTOMER SERVICE LEARNING DELIVERY CONSULTANT	JOBTITLE
CUSTOMER SERVICE MANAGER	JOBTITLE
CUSTOMER SERVICE MANAGER AND ADMINISTRATOR	JOBTITLE
CUSTOMER SERVICE REPRESENTATIVE	JOBTITLE
CUSTOMER SERVICE SALES REPRESENTATIVE	JOBTITLE
CUSTOMER SERVICE SPECIALIST	JOBTITLE
CUSTOMER SERVICE SUPERVISOR	JOBTITLE
CUSTOMER SERVICE TECHNICIAN	JOBTITLE
CUSTOMER SERVICES ADMINISTRATOR	JOBTITLE
CUSTOMER SERVICES ASSISTANT	JOBTITLE
CUSTOMER SERVICES ASSOCIATE	JOBTITLE
CUSTOMER SERVICES COORDINATOR	JOBTITLE
CUSTOMER SERVICES DIRECTOR	JOBTITLE
CUSTOMER SERVICES MANAGER	JOBTITLE
CUSTOMER SERVICES REPRESENTATIVE	JOBTITLE
CUSTOMER SERVICES SPECIALIST	JOBTITLE
CUSTOMER SERVICES SUPERVISOR	JOBTITLE
CUSTOMER SERVICES TECHNICIAN	JOBTITLE
CUSTOMER SUCCESS MANAGER	JOBTITLE
CUSTOMER SUCCESS REPRESENTATIVE	JOBTITLE
CUSTOMER SUPPORT ANALYST 	JOBTITLE
CUSTOMER SUPPORT REPRESENTATIVE	JOBTITLE
CUSTOMS ENTRY WRITER	JOBTITLE
CYBERSPACE EXERCISE INTELLIGENCE PLANNER	JOBTITLE
DANGEROUS GOODS OFFICER	JOBTITLE
DATA ANALYSIS ADVISOR	JOBTITLE
DATA ANALYST	JOBTITLE
DATA ARCHITECT	JOBTITLE
DATA COORDINATOR	JOBTITLE
DATA ENGINEER	JOBTITLE
DATA ENTRY CLERK	JOBTITLE
DATA ENTRY SPECIALIST	JOBTITLE
DATA MANAGEMENT SPECIALIST	JOBTITLE
DATA MANAGER	JOBTITLE
DATA MODELLER	JOBTITLE
DATA QUALITY ANALYST	JOBTITLE
DATA SCIENTIST	JOBTITLE
DATA SPECIALIST	JOBTITLE
DATA WAREHOUSE ENGINEER	JOBTITLE
DATABASE ADMINISTRATOR	JOBTITLE
DATABASE ANALYST	JOBTITLE
DEA ADMINISTRATOR	JOBTITLE
DEAF & HARD OF HEARING TEACHER	JOBTITLE
DEEP LEARNING RESEARCHER	JOBTITLE
DELIVERY ANALYST	JOBTITLE
DELIVERY MANAGER	JOBTITLE
DELIVERY SALES AND SERVICE ACCOUNT MANAGER	JOBTITLE
DENTAL ASSISTANT	JOBTITLE
DENTAL OFFICE ASSISTANT	JOBTITLE
DENTAL OFFICE ASSISTANT BUSINESS ASSISTANT	JOBTITLE
DEPARTMENT LEAD	JOBTITLE
DEPARTMENT MANAGER	JOBTITLE
DEPARTMENT SUPERVISOR	JOBTITLE
DEPARTMENTAL DIRECTOR	JOBTITLE
DESIGN DIRECTOR	JOBTITLE
DESIGN ENGINEER	JOBTITLE
DETAIL SPECIALIST	JOBTITLE
DEVELOPER ANALYST	JOBTITLE
DEVELOPMENT ANALYST	JOBTITLE
DEVELOPMENT COORDINATOR	JOBTITLE
DEVELOPMENT ENGINEER	JOBTITLE
DEVELOPMENT MANAGER	JOBTITLE
DIABETES INTEGRATED COMMUNITY REPRESENTATIVE	JOBTITLE
DIESEL MECHANIC	JOBTITLE
DIETARY MANAGER	JOBTITLE
DIETETIC TECHNICIAN	JOBTITLE
DIGITAL DESIGNER	JOBTITLE
DIGITAL MARKETING MANAGER	JOBTITLE
DIGITAL MARKETING SPECIALIST	JOBTITLE
DIGITAL SERVICE SPECIALIST	JOBTITLE
DIRECTOR LOCOMOTIVE	JOBTITLE
DIRECTOR LOCOMOTIVE RELIABILITY	JOBTITLE
DIRECTOR NIKE	JOBTITLE
DIRECTOR OF ADMISSIONS	JOBTITLE
DIRECTOR OF ASSESSMENT	JOBTITLE
DIRECTOR OF BUSINESS	JOBTITLE
DIRECTOR OF BUSINESS DEVELOPMENT	JOBTITLE
DIRECTOR OF CAREER SERVICES	JOBTITLE
DIRECTOR OF CASE MANAGEMENT	JOBTITLE
DIRECTOR OF CLINICAL SERVICES	JOBTITLE
DIRECTOR OF DEVELOPMENT	JOBTITLE
DIRECTOR OF FINANCE	JOBTITLE
DIRECTOR OF GRADUATE EMPLOYMENT	JOBTITLE
DIRECTOR OF HUMAN RESOURCES	JOBTITLE
DIRECTOR OF MARKETING	JOBTITLE
DIRECTOR OF NURSING	JOBTITLE
DIRECTOR OF OPERATIONS	JOBTITLE
DIRECTOR OF PARTIAL HOSPITALIZATION	JOBTITLE
DIRECTOR OF PROGRAM FOR DEMOCRATIC ENGAGEMENT AND GOVERNANCE	JOBTITLE
DIRECTOR OF SALES	JOBTITLE
DIRECTOR OF SALES AND MARKETING	JOBTITLE
DIRECTOR OF SERVICE	JOBTITLE
DIRECTOR OF STUDENT LIFE	JOBTITLE
DISABILITY MANAGEMENT SPECIALIST	JOBTITLE
DISPENSING AUDIOLOGIST	JOBTITLE
DISTRIBUTION SUPERVISOR	JOBTITLE
DISTRIBUTION TECHNICIAN	JOBTITLE
DISTRICT MANAGER	JOBTITLE
DISTRICT MERCHANDISE MANAGER	JOBTITLE
DISTRICT OPERATIONS MANAGER	JOBTITLE
DOCKETING AND RECORDS SPECIALIST	JOBTITLE
DOCUMENT CONTROL ADMINISTRATOR	JOBTITLE
DOCUMENT SPECIALIST	JOBTITLE
DOCUMENTATION SPECIALIST	JOBTITLE
DRAMA TEACHER	JOBTITLE
DREAMWEAVER WEB CONTENT DEVELOPER	JOBTITLE
DRUG SAFETY ASSOCIATE	JOBTITLE
DUTY OFFICER	JOBTITLE
EARLY CHILDHOOD EDUCATOR	JOBTITLE
EARLY CHILDHOOD SPECIAL EDUCATION TEACHER	JOBTITLE
EARLY CHILDHOOD SPECIALIST	JOBTITLE
EARLY CHILDHOOD TEACHER	JOBTITLE
ECE TEACHER	JOBTITLE
EDITORIAL ASSISTANT	JOBTITLE
EDUCATION & VOLUNTEER MANAGER	JOBTITLE
EDUCATION COORDINATOR	JOBTITLE
EDUCATION SPECIALIST	JOBTITLE
EDUCATION TEACHER 	JOBTITLE
EDUCATIONAL ASSISTANT	JOBTITLE
EDUCATIONAL AUDIOLOGIST	JOBTITLE
EDUCATIONAL COORDINATOR	JOBTITLE
EEO COORDINATOR	JOBTITLE
EFFECTIVENESS MANAGER	JOBTITLE
ELA TEACHER	JOBTITLE
ELECTRICAL ENGINEER	JOBTITLE
ELECTRICAL LINE WORKER	JOBTITLE
ELECTRICIAN	JOBTITLE
ELECTRO-MECHANICAL ENGINEER	JOBTITLE
ELECTRONICS ENGINEER	JOBTITLE
ELEMENTARY ASSISTANT	JOBTITLE
ELEMENTARY SCHOOL PRINCIPAL	JOBTITLE
ELEMENTARY TEACHER	JOBTITLE
EMEAR - UK - NETWORKING INTERN	JOBTITLE
EMERGENCY MEDICAL TECHNICIAN	JOBTITLE
EMERGENCY NURSE	JOBTITLE
EMERGENCY ROOM NURSE	JOBTITLE
EMPLOYMENT SPECIALIST	JOBTITLE
ENDOSCOPY NURSE	JOBTITLE
ENERGY CONSULTANT	JOBTITLE
ENERGY TECHNICIAN	JOBTITLE
ENGINE TECHNICIAN	JOBTITLE
ENGINEERING DIRECTOR	JOBTITLE
ENGINEERING MANAGER	JOBTITLE
ENGINEERING TECHNICIAN	JOBTITLE
ENGLISH TEACHER	JOBTITLE
ENROLLMENT COORDINATOR	JOBTITLE
ENROLLMENT COUNSELOR	JOBTITLE
ENROLLMENT SPECIALIST	JOBTITLE
ENTERPRISE ARCHITECT	JOBTITLE
ENTERPRISE IPHONE SPECIALIST	JOBTITLE
ENTERPRISE RELEASE COORDINATOR	JOBTITLE
ENTRY LEVEL ASSISTANT	JOBTITLE
ENTRY LEVEL INSIDE LIABILITY ADJUSTER	JOBTITLE
ENTRY SPECIALIST	JOBTITLE
ENVIRONMENTAL COORDINATOR	JOBTITLE
ENVIRONMENTAL ENGINEER	JOBTITLE
ENVIRONMENTAL MANAGER	JOBTITLE
ENVIRONMENTAL SERVICES DIRECTOR	JOBTITLE
ENVIRONMENTAL SPECIALIST	JOBTITLE
EPM SYSTEMS ANALYST	JOBTITLE
EQUAL OPPORTUNITY EDUCATOR	JOBTITLE
EQUIPMENT OPERATOR	JOBTITLE
ER NURSE	JOBTITLE
ESCROW ASSISTANT	JOBTITLE
ESCROW OFFICER	JOBTITLE
ESL TEACHER	JOBTITLE
EVALUATION ASSISTANT	JOBTITLE
EVENT & ADMINISTRATIVE ASSISTANT	JOBTITLE
EVENT COORDINATOR	JOBTITLE
EVENT MANAGER	JOBTITLE
EVENT PLANNER	JOBTITLE
EVENTS COORDINATOR	JOBTITLE
EVENTS MANAGER	JOBTITLE
EXECUTIVE ADMINISTRATIVE	JOBTITLE
EXECUTIVE ADMINISTRATIVE ASSISTANT	JOBTITLE
EXECUTIVE ASSISTANT	JOBTITLE
EXECUTIVE ASSISTANT/OFFICE MANAGER	JOBTITLE
EXECUTIVE CHEF	JOBTITLE
EXECUTIVE CHEF SENIOR MANAGER	JOBTITLE
EXECUTIVE DIRECTOR	JOBTITLE
EXECUTIVE HOUSEKEEPER	JOBTITLE
EXECUTIVE MANAGER	JOBTITLE
EXECUTIVE MANAGER AUTOMOTIVE	JOBTITLE
EXECUTIVE MANAGER AUTOMOTIVE OEM ACCOUNTS	JOBTITLE
EXECUTIVE RECRUITER ASSOCIATE	JOBTITLE
EXECUTIVE SUPPORT SPECIALIST	JOBTITLE
EXERCISE INTELLIGENCE PLANNER	JOBTITLE
EXHIBITIONS MANAGER	JOBTITLE
EXPERIENCE SPECIALIST	JOBTITLE
EXPERIENCE SUPERVISOR	JOBTITLE
EXPORT COMPLIANCE COORDINATOR	JOBTITLE
FABRIC MANAGEMENT ASSOCIATE	JOBTITLE
FABRIC MANAGER	JOBTITLE
FACILITATION & TRAINING SPECIALIST	JOBTITLE
FACILITIES COORDINATOR	JOBTITLE
FACILITIES MANAGER	JOBTITLE
FACILITY MANAGER	JOBTITLE
FACULTY DEVELOPMENT SPECIALIST	JOBTITLE
FACULTY MEMBER	JOBTITLE
FACULTY POSITION	JOBTITLE
FAMILY SPECIALIST	JOBTITLE
FAMILY SUPPORT WORKER	JOBTITLE
FEDERAL CONTRACTOR	JOBTITLE
FEDERAL CONTRACTS SPECIALIST	JOBTITLE
FEDEX SHIP MANAGER	JOBTITLE
FELLOWSHIP TRAINING DIRECTOR	JOBTITLE
FIBRE CHARACTERIZATION ENGINEER	JOBTITLE
FIELD ADJUSTER	JOBTITLE
FIELD CLAIMS REPRESENTATIVE	JOBTITLE
FIELD ENGINEER	JOBTITLE
FIELD MAINTENANCE TECHNICIAN	JOBTITLE
FIELD REPRESENTATIVE	JOBTITLE
FIELD SALES REPRESENTATIVE	JOBTITLE
FIELD SERVICE ENGINEER	JOBTITLE
FIELD SERVICE REPRESENTATIVE	JOBTITLE
FIELD SERVICE TECHNICIAN	JOBTITLE
FIELD SERVICES TECHNICIAN	JOBTITLE
FIELD TECHNICIAN 	JOBTITLE
FIELD TRAINING SPECIALIST	JOBTITLE
FINANCE ANALYST	JOBTITLE
FINANCE MANAGER	JOBTITLE
FINANCIAL ADVISOR	JOBTITLE
FINANCIAL ANALYST	JOBTITLE
FINANCIAL ASSISTANT	JOBTITLE
FINANCIAL CLEARANCE ASSOCIATE	JOBTITLE
FINANCIAL CONTROLLER	JOBTITLE
FINANCIAL COORDINATOR	JOBTITLE
FINANCIAL MANAGER	JOBTITLE
FINANCIAL OFFICER	JOBTITLE
FINANCIAL PLANNING ANALYST	JOBTITLE
FINANCIAL SPECIALIST	JOBTITLE
FINE ARTS TEACHER	JOBTITLE
FIRE SPRINKLER TECHNICIAN	JOBTITLE
FIRMWARE ENGINEER	JOBTITLE
FITNESS ADVISOR	JOBTITLE
FITNESS MANAGER	JOBTITLE
FITTER	JOBTITLE
FLEET TECHNICIAN	JOBTITLE
FLIGHT INSTRUCTOR	JOBTITLE
FLIGHT INSTRUCTOR .	JOBTITLE
FLORAL DESIGNER	JOBTITLE
FOOD MANUFACTURING SUPERVISOR	JOBTITLE
FOOD SERVICE WORKER	JOBTITLE
FORD DIESEL TECHNICIANS	JOBTITLE
FORENSIC ANALYST	JOBTITLE
FORKLIFT DRIVER	JOBTITLE
FORKLIFT OPERATOR	JOBTITLE
FOSTER FAMILY SPECIALIST	JOBTITLE
FPANDA ANALYST	JOBTITLE
FPGA VHDL ENGINEER	JOBTITLE
FRAUD ANALYST	JOBTITLE
FREAK ANALYST	JOBTITLE
FRONT DESK CLERK	JOBTITLE
FRONT DESK SUPERVISOR 	JOBTITLE
FRONT END DEVELOPER	JOBTITLE
FRONT OF HOUSE-RESTAURANT MANAGER	JOBTITLE
FRONT OFFICE ASSISTANT	JOBTITLE
FRONT OFFICE MANAGER	JOBTITLE
FSQA TECHNICIAN	JOBTITLE
FULL-STACK DEVELOPER	JOBTITLE
FULL-TIME CUSTOMER RELATIONS REPRESENTATIVE	JOBTITLE
FULL-TIME OR MOONLIGHTER	JOBTITLE
FUND CONTROLLER	JOBTITLE
FUND DEVELOPMENT COORDINATOR	JOBTITLE
FUNDING COORDINATOR	JOBTITLE
GAS UTILITY WORKER	JOBTITLE
GENERAL MANAGER	JOBTITLE
GENERAL OFFICE ASSISTANT	JOBTITLE
GENERAL OFFICE MANAGER	JOBTITLE
GENERAL RADIOGRAPHER	JOBTITLE
GENERAL TEACHER	JOBTITLE
GEOTECHNICAL ENGINEER	JOBTITLE
GERONTOLOGY AIDE	JOBTITLE
GERONTOLOGY SPECIALIST	JOBTITLE
GI NURSE	JOBTITLE
GLOBAL DIGITAL DIRECTOR	JOBTITLE
GLOBAL LABELING CONTRACTOR	JOBTITLE
GM TECHNICIAN	JOBTITLE
GRADUATE NURSE	JOBTITLE
GRADUATE PROFESSIONAL NURSE	JOBTITLE
GRADUATE TRAINEE	JOBTITLE
GRANTS MANAGER	JOBTITLE
GRAPHIC DESIGNER	JOBTITLE
GUEST SERVICES MANAGER	JOBTITLE
GUEST SERVICES REPRESENTATIVE	JOBTITLE
GUEST SERVICES SUPERVISOR	JOBTITLE
GUIDANCE COUNSELOR	JOBTITLE
HANDYMAN	JOBTITLE
HANDYMAN CARPENTER	JOBTITLE
HCS SUPERVISOR	JOBTITLE
HEAD START TEACHER	JOBTITLE
HEALTH AND WELLNESS ASSOCIATE	JOBTITLE
HEALTH ASSOCIATE	JOBTITLE
HEALTH CARE COORDINATOR	JOBTITLE
HEALTH CARE PROJECT MANAGER	JOBTITLE
HEALTH CENTER MANAGER	JOBTITLE
HEALTH EDUCATION SPECIALIST	JOBTITLE
HEALTH SPECIALIST	JOBTITLE
HEALTH TECHNICIAN	JOBTITLE
HEALTH THERAPIST	JOBTITLE
HEALTH UNIT COORDINATOR	JOBTITLE
HEALTHCARE ACCOUNT MANAGER	JOBTITLE
HEALTHCARE DEVELOPMENT MANAGER	JOBTITLE
HEARING INSTRUMENT SPECIALIST	JOBTITLE
HEATING AND AIR CONDITIONING INSTALLER	JOBTITLE
HEAVY EQUIPMENT MECHANIC	JOBTITLE
HEAVY TRACK MECHANIC	JOBTITLE
HEAVY TRUCK MECHANICS	JOBTITLE
HELPDESK SPECIALIST	JOBTITLE
HIGH SCHOOL TEACHER	JOBTITLE
HIRING COORDINATOR 	JOBTITLE
HIRING MANAGER	JOBTITLE
HISTOLOGY TECHNICIAN	JOBTITLE
HMH MARKETING MANAGER	JOBTITLE
HOME CARE AIDE	JOBTITLE
HOME HEALTH AIDE	JOBTITLE
HOME HEALTH AIDES	JOBTITLE
HOME IMPROVEMENT SPECIALIST	JOBTITLE
HOME SALES ASSOCIATE	JOBTITLE
HOME SUPERVISOR	JOBTITLE
HOME SUPPORT WORKER	JOBTITLE
HOMEROOM TEACHER	JOBTITLE
HOSPICE AIDE	JOBTITLE
HOURLY PAID LECTURER	JOBTITLE
HOUSE MANAGER	JOBTITLE
HOUSE SUPERVISOR	JOBTITLE
HOUSING SUPPORT WORKER	JOBTITLE
HR ADMINISTRATOR	JOBTITLE
HR ADVISOR	JOBTITLE
HR ANALYST	JOBTITLE
HR AND OFFICE MANAGER	JOBTITLE
HR ASSISTANT	JOBTITLE
HR BENEFITS SPECIALIST	JOBTITLE
HR COORDINATOR	JOBTITLE
HR GENERALIST	JOBTITLE
HR MANAGER	JOBTITLE
HR SPECIALIST	JOBTITLE
HRIS ANALYST	JOBTITLE
HTPN HEALTH COORDINATOR	JOBTITLE
HUMAN RESOURCE ANALYST	JOBTITLE
HUMAN RESOURCE COORDINATOR	JOBTITLE
HUMAN RESOURCE MANAGER	JOBTITLE
HUMAN RESOURCES ADMINISTRATOR	JOBTITLE
HUMAN RESOURCES ANALYST	JOBTITLE
HUMAN RESOURCES ASSISTANT	JOBTITLE
HUMAN RESOURCES COORDINATOR	JOBTITLE
HUMAN RESOURCES DIRECTOR	JOBTITLE
HUMAN RESOURCES GENERALIST	JOBTITLE
HUMAN RESOURCES MANAGER	JOBTITLE
HUMAN RESOURCES REPRESENTATIVE	JOBTITLE
HUMAN RESOURCES SECURITY SPECIALIST	JOBTITLE
HUMAN RESOURCES SPECIALIST	JOBTITLE
HUMAN RIGHTS ADVOCATE	JOBTITLE
HUMAN SERVICES SUPERVISOR	JOBTITLE
HVAC LEAD	JOBTITLE
HVAC TECHNICIAN	JOBTITLE
ICU CRITICAL CARE NURSE	JOBTITLE
ICU NURSE	JOBTITLE
IMAGING TECHNOLOGIST	JOBTITLE
IMPLEMENTATION ADMINISTRATOR	JOBTITLE
IMPLEMENTATION ANALYST	JOBTITLE
IMPLEMENTATION CONSULTANT	JOBTITLE
IMPLEMENTATION MANAGER 	JOBTITLE
IMPLEMENTATION SPECIALIST	JOBTITLE
IMPORT COORDINATOR	JOBTITLE
IN BASIC LIFE SUPPORT	JOBTITLE
INBOUND CALL CENTER REPRESENTATIVE	JOBTITLE
INCIDENT MANAGER	JOBTITLE
INDEPENDENT CONTRACTOR	JOBTITLE
INDUSTRIAL ELECTRICIAN	JOBTITLE
INDUSTRIAL REFRIGERATION WELDER	JOBTITLE
INFANT AND TODDLER TEACHER	JOBTITLE
INFANT PRESCHOOLER MENTAL HEALTH SPECIALIST	JOBTITLE
INFORMATICS PROJECT MANAGER	JOBTITLE
INFORMATION OFFICER	JOBTITLE
INFORMATION SECURITY SPECIALIST	JOBTITLE
INFORMATION SPECIALIST	JOBTITLE
INFORMATION SYSTEMS SPECIALIST	JOBTITLE
INFORMATION TECHNOLOGY SPECIALIST	JOBTITLE
INFRASTRUCTURE ANALYST	JOBTITLE
INSIDE LIABILITY ADJUSTER	JOBTITLE
INSIDE SALES ASSOCIATE	JOBTITLE
INSIDE SALES EXECUTIVE	JOBTITLE
INSIDE SALES REPRESENTATIVE	JOBTITLE
INSIDE WIREMAN	JOBTITLE
INSIGHT ANALYST	JOBTITLE
INSTALLATION COORDINATOR	JOBTITLE
INSTALLATION SPECIALIST 	JOBTITLE
INSTALLATION TECHNICIAN	JOBTITLE
INSTRUCTIONAL ASSISTANT	JOBTITLE
INSTRUCTIONAL DESIGN AND DEVELOPMENT ANALYST	JOBTITLE
INSTRUCTIONAL DESIGNER	JOBTITLE
INSTRUCTIONAL SPECIALIST	JOBTITLE
INSTRUCTIONAL SYSTEMS SPECIALIST	JOBTITLE
INSURANCE ACCOUNT REPRESENTATIVE	JOBTITLE
INSURANCE ADJUSTER	JOBTITLE
INSURANCE AUTHORIZATION SPECIALIST	JOBTITLE
INSURANCE BENEFITS/PRECERT COORDINATOR	JOBTITLE
INSURANCE BROKER	JOBTITLE
INSURANCE SPECIALIST	JOBTITLE
INTAKE SPECIALIST 	JOBTITLE
INTEGRATION MANAGER	JOBTITLE
INTEGRATION SPECIALIST 	JOBTITLE
INTEGRITY OFFICER	JOBTITLE
INTELLIGENCE ANALYST	JOBTITLE
INTELLIGENCE PLANNER	JOBTITLE
INTELLIGENCE SPECIALIST	JOBTITLE
INTERCONNECTION SPECIALIST	JOBTITLE
INTERIM SAS MODELLER	JOBTITLE
INTERIOR ARCHITECT	JOBTITLE
INTERIOR DESIGNER	JOBTITLE
INTERNAL AUDITOR	JOBTITLE
INTERNSHIP AND POST-DOC FELLOWSHIP TRAINING DIRECTOR	JOBTITLE
INTERNSHIP OR TEACHER 	JOBTITLE
INTERPRETER	JOBTITLE
INTERVENTION SPECIALIST	JOBTITLE
INTERVENTION TEACHER 	JOBTITLE
INTERVENTIONIST TEACHER	JOBTITLE
INTERVENTIONIST TEACHER ASSISTANT	JOBTITLE
INVENTORY COORDINATOR	JOBTITLE
INVENTORY MANAGER	JOBTITLE
INVENTORY SPECIALIST	JOBTITLE
INVESTIGATIONS MANAGER	JOBTITLE
INVESTIGATIVE MANAGER	JOBTITLE
INVESTMENT ADVISOR	JOBTITLE
INVESTMENT ANALYST	JOBTITLE
INVESTMENT MANAGER	JOBTITLE
INVESTMENT OFFICER	JOBTITLE
INVOICING COORDINATOR	JOBTITLE
IPHONE SPECIALIST	JOBTITLE
IT PROJECT COORDINATOR	JOBTITLE
IT PROJECT MANAGER	JOBTITLE
IT SYSTEMS ADMINISTRATOR	JOBTITLE
ITALIAN DESIGNER	JOBTITLE
JANITOR	JOBTITLE
JAVA DEVELOPER	JOBTITLE
JAVA PROGRAMMER	JOBTITLE
JAVASCRIPT PROGRAMMER	JOBTITLE
JOB DEVELOPER	JOBTITLE
JOURNEYMAN ELECTRICIAN	JOBTITLE
JUVENILE INSTITUTIONAL OFFICER	JOBTITLE
JV DRIVER	JOBTITLE
KEY ACCOUNT MANAGER	JOBTITLE
KINDERGARTEN TEACHER 	JOBTITLE
KOMPASS REPRESENTATIVE	JOBTITLE
KYC OFFICER	JOBTITLE
LAB ASSISTANT	JOBTITLE
LAB TECHNICIAN	JOBTITLE
LAB TECHNICIAN 	JOBTITLE
LABORATORY ASSISTANT	JOBTITLE
LABORATORY DIRECTOR	JOBTITLE
LABORATORY MANAGER	JOBTITLE
LABORATORY SUPERVISOR	JOBTITLE
LABORATORY TECHNICIAN	JOBTITLE
LANDSCAPE TECHNICIAN	JOBTITLE
LANGUAGE INSTRUCTOR	JOBTITLE
LASER TECHNICIAN	JOBTITLE
LAW ASSOCIATE	JOBTITLE
LAWN APPLICATION TECHNICIAN	JOBTITLE
LEAD ACCOUNTANT	JOBTITLE
LEAD DATA SCIENTIST	JOBTITLE
LEAD ENGINEER	JOBTITLE
LEAD ENGINEER 	JOBTITLE
LEAD GENERATION SPECIALIST	JOBTITLE
LEAD INVESTIGATOR	JOBTITLE
LEAD LASER SPECIALIST	JOBTITLE
LEAD SCIENTIST	JOBTITLE
LEAD TEACHER 	JOBTITLE
LEAD TECHNICAL ENGINEER	JOBTITLE
LEAD TECHNICIAN	JOBTITLE
LEAD TELLER	JOBTITLE
LEADING WATER FLOW SPECIALIST	JOBTITLE
LEARNING & DEVELOPMENT SPECIALIST	JOBTITLE
LEARNING AND DEVELOPMENT SPECIALIST	JOBTITLE
LEARNING SPECIALIST	JOBTITLE
LEASE ADMINISTRATOR	JOBTITLE
LEASING COORDINATOR	JOBTITLE
LECTURER	JOBTITLE
LECTURER SENIOR LECTURER	JOBTITLE
LEGAL ACCOUNT EXECUTIVE	JOBTITLE
LEGAL ADMINISTRATIVE ASSISTANT	JOBTITLE
LEGAL ASSISTANT	JOBTITLE
LEGAL CLAIMS EXAMINER	JOBTITLE
LEGAL SECRETARY	JOBTITLE
LIABILITY ADJUSTER	JOBTITLE
LIBRARY ASSISTANT	JOBTITLE
LIBRARY TECHNICAL ASSISTANT	JOBTITLE
LIBRARY TECHNICIAN	JOBTITLE
LICENSED PLUMBER	JOBTITLE
LIFE COORDINATOR	JOBTITLE
LIFESTYLE COORDINATOR 	JOBTITLE
LIGHT TRACK MECHANIC	JOBTITLE
LINEMAN	JOBTITLE
LISTING COORDINATOR	JOBTITLE
LITERACY SPECIALIST 	JOBTITLE
LITIGATION APPLICATIONS ADMINISTRATOR	JOBTITLE
LITIGATION SPECIALIST	JOBTITLE
LOAN OFFICER	JOBTITLE
LOCAL RECRUITER	JOBTITLE
LOGISTICS ANALYST	JOBTITLE
LOGISTICS COORDINATOR	JOBTITLE
LOGISTICS SPECIALIST	JOBTITLE
LOGISTICS SUPERVISOR	JOBTITLE
LOOKING FOR SPECIALIST	JOBTITLE
LPN	JOBTITLE
LPN CHARGE NURSE	JOBTITLE
LSS BUSINESS LEAD	JOBTITLE
MAC ARTIST	JOBTITLE
MACHINE OPERATOR	JOBTITLE
MAILROOM AND FACILITIES ADMINISTRATOR	JOBTITLE
MAIN CONTRACTOR	JOBTITLE
MAINTENANCE AND RELIABILITY TECHNICIAN	JOBTITLE
MAINTENANCE DIRECTOR	JOBTITLE
MAINTENANCE ELECTRICIAN	JOBTITLE
MAINTENANCE MANAGER	JOBTITLE
MAINTENANCE MANAGER TRAINEE	JOBTITLE
MAINTENANCE SPECIALIST	JOBTITLE
MAINTENANCE SUPERVISOR	JOBTITLE
MAINTENANCE TECHNICIAN	JOBTITLE
MAINTENANCE UTILITY WORKER	JOBTITLE
MAINTENANCE WORKER	JOBTITLE
MAJOR GIFTS OFFICER	JOBTITLE
MAMMOGRAPHY X-RAY TECHNOLOGIST	JOBTITLE
MANAGEMENT ANALYST	JOBTITLE
MANAGEMENT ASSISTANT	JOBTITLE
MANAGEMENT ASSOCIATE	JOBTITLE
MANAGEMENT CONSULTANT	JOBTITLE
MANAGEMENT COORDINATOR	JOBTITLE
MANAGEMENT SALES TRAINEE	JOBTITLE
MANAGEMENT SPECIALIST	JOBTITLE
MANAGEMENT SYSTEMS ANALYST	JOBTITLE
MANAGEMENT TRAINEE	JOBTITLE
MANAGER ACCOUNT ACTIVATION	JOBTITLE
MANAGER AUTOMOTIVE OEM ACCOUNTS	JOBTITLE
MANAGER FOOD SERVICE	JOBTITLE
MANAGER FOR HOTEL PERFORMANCE	JOBTITLE
MANAGER OF FINANCE	JOBTITLE
MANAGER OF GUEST RELATIONS	JOBTITLE
MANAGER OF HOSPITALITY	JOBTITLE
MANAGER OF HOUSING	JOBTITLE
MANAGER OF NURSING	JOBTITLE
MANAGER OF PAYROLL	JOBTITLE
MANAGER OF TUNNELING OPERATIONS	JOBTITLE
MANAGING CONSULTANT	JOBTITLE
MANAGING DIRECTOR	JOBTITLE
MANUFACTURING ENGINEER	JOBTITLE
MARKETING ANALYST	JOBTITLE
MARKETING ASSISTANT	JOBTITLE
MARKETING ASSOCIATE	JOBTITLE
MARKETING COMMUNICATIONS ASSISTANT	JOBTITLE
MARKETING COORDINATOR	JOBTITLE
MARKETING DIRECTOR	JOBTITLE
MARKETING EXECUTIVE	JOBTITLE
MARKETING INTERN	JOBTITLE
MARKETING MANAGER	JOBTITLE
MARKETING REPRESENTATIVE	JOBTITLE
MARKETING SPECIALIST	JOBTITLE
MASSAGE THERAPIST	JOBTITLE
MASTER AGREEMENT	JOBTITLE
MASTER DATA SPECIALIST	JOBTITLE
MASTER TEACHER	JOBTITLE
MATH TEACHER	JOBTITLE
MATHEMATICS INSTRUCTOR	JOBTITLE
MDM CONSULTANT	JOBTITLE
MDS COORDINATOR	JOBTITLE
MECHANICAL DESIGN ENGINEER	JOBTITLE
MECHANICAL ENGINEER	JOBTITLE
MECHATRONICS ENGINEER	JOBTITLE
MED AIDE	JOBTITLE
MED TECHNOLOGIST	JOBTITLE
MEDIA ANALYST	JOBTITLE
MEDIA BUYER	JOBTITLE
MEDIA CONSULTANT	JOBTITLE
MEDIA PLANNER	JOBTITLE
MEDIA SPECIALIST	JOBTITLE
MEDICAID IMPLEMENTATION ADMINISTRATOR	JOBTITLE
MEDICAL ADMINISTRATIVE ASSISTANT	JOBTITLE
MEDICAL ADMINISTRATIVE OFFICE TECHNICIAN	JOBTITLE
MEDICAL ASSISTANT	JOBTITLE
MEDICAL ASSISTANT .	JOBTITLE
MEDICAL BILLING & CODING	JOBTITLE
MEDICAL BILLING SPECIALIST	JOBTITLE
MEDICAL CODING SPECIALIST	JOBTITLE
MEDICAL DIRECTOR	JOBTITLE
MEDICAL INFORMATION ASSOCIATE	JOBTITLE
MEDICAL LAB SCIENTIST	JOBTITLE
MEDICAL LABORATORY TECHNICIAN	JOBTITLE
MEDICAL LABORATORY TECHNOLOGIST	JOBTITLE
MEDICAL OFFICE ASSISTANT	JOBTITLE
MEDICAL OFFICE COORDINATOR	JOBTITLE
MEDICAL RECEPTIONIST	JOBTITLE
MEDICAL RECORD TECHNICIAN	JOBTITLE
MEDICAL RECORDS CODER	JOBTITLE
MEDICAL SUPPORT ASSISTANT	JOBTITLE
MEDICAL TECHNICIAN	JOBTITLE
MEDICAL TECHNOLOGIST 	JOBTITLE
MEDICAL TECHNOLOGY COORDINATOR	JOBTITLE
MEDICATION AIDE	JOBTITLE
MEDICINAL CHEMIST	JOBTITLE
MED-SURG NURSE	JOBTITLE
MEMBER SERVICE SPECIALIST	JOBTITLE
MENTAL HEALTH ASSOCIATE	JOBTITLE
MENTAL HEALTH COUNSELOR	JOBTITLE
MENTAL HEALTH COUNSELORS	JOBTITLE
MENTAL HEALTH PRACTITIONER	JOBTITLE
MENTAL HEALTH TECHNICIAN	JOBTITLE
MENTAL HEALTH THERAPIST	JOBTITLE
MENTAL HEALTH WORKER	JOBTITLE
MENTOR TEACHER	JOBTITLE
MERCHANDISE MANAGER	JOBTITLE
MICROCOMPUTER ACCOUNTING CLERK	JOBTITLE
MICROCOMPUTER SPECIALIST	JOBTITLE
MICROSOFT DYNAMICS CRM LEAD	JOBTITLE
MICROSOFT OFFICE SPECIALIST	JOBTITLE
MIDDLE SCHOOL TEACHER	JOBTITLE
MITIGATION SPECIALIST	JOBTITLE
MOLD SPECIALIST	JOBTITLE
MORTGAGE LOAN OFFICER	JOBTITLE
MR TECHNOLOGIST	JOBTITLE
MRI TECHNOLOGIST	JOBTITLE
NATURAL RESOURCE SPECIALIST	JOBTITLE
NEEDS SPECIALIST	JOBTITLE
NET DEVELOPER	JOBTITLE
NETWORK ADMINISTRATOR	JOBTITLE
NETWORK ANALYST	JOBTITLE
NETWORK ENGINEER	JOBTITLE
NETWORK MANAGER	JOBTITLE
NETWORK SECURITY SPECIALIST	JOBTITLE
NETWORK SPECIALIST	JOBTITLE
NETWORKING TECHNICIANS	JOBTITLE
NEW HOME SALES ASSOCIATE	JOBTITLE
NEW SENIOR ASSOCIATE	JOBTITLE
NEXTGEN EPM SYSTEMS ANALYST	JOBTITLE
NIGHT AUDITOR	JOBTITLE
NIGHT MANAGER 	JOBTITLE
NIMS CNC OPERATOR	JOBTITLE
NURSE EDUCATOR	JOBTITLE
NURSE MANAGER	JOBTITLE
NURSE MANAGER 	JOBTITLE
NURSE PARALEGAL	JOBTITLE
NURSE PRACTITIONER	JOBTITLE
NURSING AIDE	JOBTITLE
NURSING ASSISTANT	JOBTITLE
OBSTETRICS AND GYNECOLOGY ASSISTANT	JOBTITLE
OCCUPANCY SPECIALIST	JOBTITLE
OCCUPATIONAL HEALTH ADVISOR	JOBTITLE
OCCUPATIONAL THERAPIST	JOBTITLE
OCCUPATIONAL THERAPIST ASSISTANT	JOBTITLE
OCCUPATIONAL THERAPY	JOBTITLE
OCCUPATIONAL THERAPY ASSISTANT	JOBTITLE
OCCUPATIONAL THERAPY ASST.	JOBTITLE
OFFICE ADMINISTRATOR	JOBTITLE
OFFICE ASSISTANT	JOBTITLE
OFFICE ASSISTANT BUSINESS ASSISTANT	JOBTITLE
OFFICE ASSOCIATE	JOBTITLE
OFFICE CLERK	JOBTITLE
OFFICE COORDINATOR	JOBTITLE
OFFICE FILE CLERK	JOBTITLE
OFFICE LEADER	JOBTITLE
OFFICE MANAGER	JOBTITLE
OFFICE REPRESENTATIVE	JOBTITLE
OFFICE SPECIALIST	JOBTITLE
OFFICE SUPERVISOR	JOBTITLE
OFFICER OF ADMINISTRATION	JOBTITLE
ONCOLOGY DATA SPECIALIST	JOBTITLE
ONE-ON-ONE TEACHER	JOBTITLE
ONSITE ACCESS SERVICES MANAGER	JOBTITLE
OPERATING OFFICER	JOBTITLE
OPERATING ROOM NURSE	JOBTITLE
OPERATIONS ANALYST	JOBTITLE
OPERATIONS AND POLICY ANALYST	JOBTITLE
OPERATIONS ASSISTANT	JOBTITLE
OPERATIONS ASSOCIATE	JOBTITLE
OPERATIONS COORDINATOR	JOBTITLE
OPERATIONS DIRECTOR	JOBTITLE
OPERATIONS LEAD	JOBTITLE
OPERATIONS MANAGER	JOBTITLE
OPERATIONS OFFICER	JOBTITLE
OPERATIONS PROJECT MANAGER	JOBTITLE
OPERATIONS SPECIALIST	JOBTITLE
OPERATIONS SUPERVISOR	JOBTITLE
OPERATIONS SUPERVISOR OR LABORATORY SUPERVISOR	JOBTITLE
OPHTHALMIC SCRIBE AND ASSISTANT	JOBTITLE
OPHTHALMIC TECHNICIAN	JOBTITLE
OPTOMETRIC ASSISTANT	JOBTITLE
ORCHESTRA TEACHER	JOBTITLE
ORDER MANAGEMENT REPRESENTATIVE	JOBTITLE
ORGANIZATION EFFECTIVENESS MANAGER	JOBTITLE
ORGANIZATIONAL DEVELOPMENT MANAGER 	JOBTITLE
ORIENTATION & MOBILITY SPECIALIST	JOBTITLE
OSP TECHNICIAN	JOBTITLE
OUTLET MANAGER	JOBTITLE
OUTREACH ASSISTANT	JOBTITLE
OUTREACH COORDINATOR	JOBTITLE
OUTREACH SPECIALIST	JOBTITLE
OUTSIDE SALES EXECUTIVE	JOBTITLE
OUTSIDE SALES REPRESENTATIVE	JOBTITLE
PACIFIC SALES CUSTOMER SERVICE SPECIALIST	JOBTITLE
PACS ADMINISTRATOR	JOBTITLE
PAPER MACHINE MANAGER	JOBTITLE
PARAPROFESSIONAL LIBRARIAN	JOBTITLE
PARENT EDUCATOR	JOBTITLE
PARENT OR LEGAL GUARDIAN	JOBTITLE
PART TIME EVENT & ADMINISTRATIVE ASSISTANT	JOBTITLE
PART TIME LECTURER	JOBTITLE
PARTNER MANAGER	JOBTITLE
PART-TIME FIREFIGHTER	JOBTITLE
PART-TIME WIND SPECIALIST	JOBTITLE
PATENT DOCKETING AND RECORDS SPECIALIST	JOBTITLE
PATIENT ACCESS REPRESENTATIVE	JOBTITLE
PATIENT ACCESS SPECIALIST	JOBTITLE
PATIENT ACCOUNT SPECIALIST	JOBTITLE
PATIENT ADVOCATE	JOBTITLE
PATIENT AUTHORIZATION REPRESENTATIVE	JOBTITLE
PATIENT BENEFITS COUNSELOR	JOBTITLE
PATIENT CARE COORDINATOR	JOBTITLE
PATIENT CARE MANAGER	JOBTITLE
PATIENT CARE TECH ASSOCIATE	JOBTITLE
PATIENT CARE TECHNICIAN	JOBTITLE
PATIENT COORDINATOR	JOBTITLE
PATIENT RELATIONS REPRESENTATIVE	JOBTITLE
PATIENT SERVICES COORDINATOR	JOBTITLE
PAYABLE ANALYST	JOBTITLE
PAYABLE MANAGER	JOBTITLE
PAYROLL & ATTENDANCE COORDINATOR	JOBTITLE
PAYROLL ASSOCIATE	JOBTITLE
PAYROLL CLERK	JOBTITLE
PAYROLL COORDINATOR	JOBTITLE
PAYROLL MANAGER	JOBTITLE
PAYROLL SPECIALIST	JOBTITLE
PE TEACHER 	JOBTITLE
PEACE OFFICER	JOBTITLE
PEACE OFFICER	JOBTITLE
PEDIATRIC CARE COORDINATOR	JOBTITLE
PEDIATRIC DENTAL ASSISTANT	JOBTITLE
PEER REVIEW COORDINATOR	JOBTITLE
PERFORMANCE ANALYST	JOBTITLE
PERFORMANCE IMPROVEMENT SPECIALIST	JOBTITLE
PERFORMANCE MANAGER	JOBTITLE
PERFORMANCE SPECIALIST	JOBTITLE
PERSONAL ASSISTANT	JOBTITLE
PERSONAL BANKER	JOBTITLE
PERSONAL FITNESS TRAINER	JOBTITLE
PERSONAL TRAINER	JOBTITLE
PERSONNEL SECURITY SPECIALIST	JOBTITLE
PET CARE ASSOCIATE	JOBTITLE
PET CONSULTANT	JOBTITLE
PHARMACEUTICAL SALES REPRESENTATIVE	JOBTITLE
PHARMACOVIGILANCE TECHNICAL OFFICER	JOBTITLE
PHARMACY INTERN	JOBTITLE
PHARMACY MANAGER	JOBTITLE
PHARMACY TECHNICIAN	JOBTITLE
PHARMACY TECHNICIAN LICENSE	JOBTITLE
PHONE TECHNICIAN	JOBTITLE
PHP PROGRAMMER	JOBTITLE
PHYSICAL THERAPIST	JOBTITLE
PHYSICAL THERAPIST ASSISTANT	JOBTITLE
PHYSICAL THERAPY ASSISTANT	JOBTITLE
PHYSICIAN ASSISTANT	JOBTITLE
PHYSICIAN LIAISON	JOBTITLE
PHYSIOTHERAPY ASSISTANT	JOBTITLE
PIANO TEACHER	JOBTITLE
PILATES INSTRUCTOR	JOBTITLE
PILATES MAT & REFORMER INSTRUCTOR	JOBTITLE
PILATES MAT INSTRUCTOR	JOBTITLE
PIPEFITTER	JOBTITLE
PIR ASSOCIATE	JOBTITLE
PLANNER 3 -LRB- COASTAL SHORES SPECIALIST	JOBTITLE
PLANNING ANALYST	JOBTITLE
PLANNING COORDINATOR	JOBTITLE
PLANNING MANAGER	JOBTITLE
PLANNING SPECIALIST	JOBTITLE
PLANS EXAMINER	JOBTITLE
PLANT MANAGER	JOBTITLE
PLC FACILITATOR	JOBTITLE
PLUMBER	JOBTITLE
PMO ANALYST	JOBTITLE
POLICE COMMUNICATIONS SPECIALIST	JOBTITLE
POLICE OFFICER	JOBTITLE
POLICY ANALYST	JOBTITLE
POLICY OFFICER	JOBTITLE
POLYSOMNOGRAPHIC TECHNOLOGIST	JOBTITLE
POOL OPERATOR	JOBTITLE
POOL OPERATOR CERTIFICATION	JOBTITLE
PORTFOLIO ANALYST	JOBTITLE
PORTFOLIO GUIDELINES ANALYSIS ANALYST	JOBTITLE
PORTFOLIO MANAGER	JOBTITLE
POSITION OF ANALYST	JOBTITLE
POST-DOC FELLOWSHIP TRAINING DIRECTOR	JOBTITLE
POWERPLANT SUPERVISOR	JOBTITLE
PRACTICAL NURSE	JOBTITLE
PRACTICE MANAGER	JOBTITLE
PRE SCHOOL TEACHER	JOBTITLE
PREMIER BANKER	JOBTITLE
PRESCHOOL TEACHER	JOBTITLE
PRESCRIBING ADVISOR	JOBTITLE
PRESIDENT/CHIEF OPERATING OFFICER	JOBTITLE
PRESVCS LEAD	JOBTITLE
PREVENTION SPECIALIST	JOBTITLE
PRICE METHODOLOGY AND MARKET SPECIALIST	JOBTITLE
PRICING ANALYST	JOBTITLE
PRICING SPECIALIST	JOBTITLE
PRINCIPAL	JOBTITLE
PRINCIPAL ADMINISTRATIVE ANALYST	JOBTITLE
PRINCIPAL DATA ANALYST	JOBTITLE
PRINCIPAL DEVELOPER	JOBTITLE
PRINCIPAL INVESTIGATOR	JOBTITLE
PRINCIPLE DEVELOPER	JOBTITLE
PRIVATE CLIENT GROUP PRODUCER	JOBTITLE
PRIVATE ESTATE MANAGER	JOBTITLE
PRO TEM INSTRUCTOR	JOBTITLE
PROBATION OFFICER	JOBTITLE
PROCUREMENT ANALYST	JOBTITLE
PROCUREMENT AND CONTRACT SPECIALIST	JOBTITLE
PROCUREMENT MANAGER	JOBTITLE
PROCUREMENT SPECIALIST	JOBTITLE
PRODUCER BROKER	JOBTITLE
PRODUCT ANALYST	JOBTITLE
PRODUCT AND MARKETING SPECIALIST	JOBTITLE
PRODUCT CONSULTANT	JOBTITLE
PRODUCT MANAGER	JOBTITLE
PRODUCT MANAGER 	JOBTITLE
PRODUCT MARKETING MANAGER	JOBTITLE
PRODUCT SPECIALIST	JOBTITLE
PRODUCTION ARTIST	JOBTITLE
PRODUCTION ASSISTANT	JOBTITLE
PRODUCTION COORDINATOR	JOBTITLE
PRODUCTION MANAGER 	JOBTITLE
PRODUCTION SPECIALIST 	JOBTITLE
PRODUCTION SUPERVISOR 	JOBTITLE
PRODUCTS REPRESENTATIVE	JOBTITLE
PROFESSIONAL ACCOUNTANT CPA	JOBTITLE
PROFESSIONAL CODER	JOBTITLE
PROFESSIONAL COUNSELOR	JOBTITLE
PROFESSIONAL DEVELOPMENT SPECIALIST	JOBTITLE
PROFESSIONAL ENGINEER	JOBTITLE
PROFESSIONAL MANAGER	JOBTITLE
PROFESSIONAL MEDICAL SERVICES MANAGEMENT	JOBTITLE
PROFESSIONAL OPTOMETRIST	JOBTITLE
PROFESSIONAL PRACTICE LEADER	JOBTITLE
PROFESSIONAL SERVICE COORDINATOR	JOBTITLE
PROFESSIONAL SERVICES CONSULTANT	JOBTITLE
PROGRAM & POLICY COORDINATOR	JOBTITLE
PROGRAM ADMINISTRATOR	JOBTITLE
PROGRAM ANALYST	JOBTITLE
PROGRAM ASSISTANT	JOBTITLE
PROGRAM ASSOCIATE	JOBTITLE
PROGRAM COORDINATOR	JOBTITLE
PROGRAM COORDINATOR 	JOBTITLE
PROGRAM DEVELOPMENT COORDINATOR	JOBTITLE
PROGRAM DIRECTOR	JOBTITLE
PROGRAM MANAGEMENT ANALYST	JOBTITLE
PROGRAM MANAGEMENT SPECIALIST	JOBTITLE
PROGRAM MANAGER	JOBTITLE
PROGRAM MANAGER 	JOBTITLE
PROGRAM OFFICER	JOBTITLE
PROGRAM SPECIALIST 	JOBTITLE
PROGRAM SUPERVISOR	JOBTITLE
PROGRAM SUPPORT SPECIALIST 	JOBTITLE
PROGRAM TEACHER	JOBTITLE
PROGRAM TECHNICIAN	JOBTITLE
PROGRAM THERAPIST	JOBTITLE
PROGRAMME CO-ORDINATOR	JOBTITLE
PROGRAMME MANAGER	JOBTITLE
PROGRAMMER ANALYST	JOBTITLE
PROGRAMS ASSISTANT	JOBTITLE
PROGRAMS ASSOCIATE	JOBTITLE
PROGRAMS SPECIALIST	JOBTITLE
PROJECT ACCOUNTING COORDINATOR	JOBTITLE
PROJECT ADMINISTRATOR	JOBTITLE
PROJECT ANALYST	JOBTITLE
PROJECT ASSISTANT	JOBTITLE
PROJECT CONTROLS LEAD	JOBTITLE
PROJECT CONTROLS MANAGER	JOBTITLE
PROJECT CONTROLS SPECIALIST	JOBTITLE
PROJECT COORDINATOR	JOBTITLE
PROJECT DIRECTOR	JOBTITLE
PROJECT ENGINEER	JOBTITLE
PROJECT LEAD	JOBTITLE
PROJECT MANAGEMENT ANALYST	JOBTITLE
PROJECT MANAGER	JOBTITLE
PROJECT SPECIALIST	JOBTITLE
PROJECT SPECIALIST 	JOBTITLE
PROJECTIONS ANALYST	JOBTITLE
PROJECTS COORDINATOR	JOBTITLE
PROMOTIONS ASSISTANT	JOBTITLE
PROPERTY MANAGER	JOBTITLE
PROPERTY MANAGER 	JOBTITLE
PROPOSAL COORDINATOR	JOBTITLE
PROPOSAL MANAGER	JOBTITLE
PROPOSAL WRITER	JOBTITLE
PROTECTION ASSOCIATE	JOBTITLE
PROTECTION OFFICER	JOBTITLE
PROTOTYPE STORES SUPERVISOR	JOBTITLE
PROVIDER RELATIONS REPRESENTATIVE	JOBTITLE
PROVIDER SPECIALIST	JOBTITLE
PRUDENTIAL RISK SPECIALIST	JOBTITLE
PSYCHOLOGICAL ASSISTANT/OFFICE COORDINATOR	JOBTITLE
PUBLIC ACCOUNTANT	JOBTITLE
PUBLIC AFFAIRS SPECIALIST	JOBTITLE
PUBLIC POLICY ASSOCIATE	JOBTITLE
PUBLIC RELATIONS COORDINATOR	JOBTITLE
PUBLIC RELATIONS MANAGER	JOBTITLE
PUBLIC RELATIONS REPRESENTATIVE	JOBTITLE
PUBLIC SAFETY OFFICER	JOBTITLE
PUBLISHING/REPRODUCTION SPECIALIST	JOBTITLE
PURCHASING ANALYST	JOBTITLE
PURCHASING COORDINATOR	JOBTITLE
PURCHASING MANAGER	JOBTITLE
PURCHASING OFFICER	JOBTITLE
PURCHASING SPECIALIST	JOBTITLE
QA ANALYST	JOBTITLE
QA LEAD	JOBTITLE
QA OFFICER	JOBTITLE
QA SPECIALIST	JOBTITLE
QA TECHNICIAN	JOBTITLE
QAP COORDINATOR	JOBTITLE
QC ANALYST	JOBTITLE
QC MANAGER	JOBTITLE
QUALITY ANALYST	JOBTITLE
QUALITY ASSOCIATE	JOBTITLE
QUALITY ASSURANCE ANALYST	JOBTITLE
QUALITY ASSURANCE ASSOCIATE	JOBTITLE
QUALITY ASSURANCE LEAD	JOBTITLE
QUALITY ASSURANCE MANAGER	JOBTITLE
QUALITY ASSURANCE NURSE	JOBTITLE
QUALITY ASSURANCE SPECIALIST	JOBTITLE
QUALITY CONTROL MANAGER	JOBTITLE
QUALITY CONTROL SPECIALIST	JOBTITLE
QUALITY CONTROL TECHNICIAN	JOBTITLE
QUALITY ENGINEER	JOBTITLE
QUALITY IMPROVEMENT COORDINATOR	JOBTITLE
QUALITY IMPROVEMENT SPECIALIST	JOBTITLE
QUALITY MANAGEMENT ANALYST	JOBTITLE
QUALITY MANAGER	JOBTITLE
QUALITY SPECIALIST	JOBTITLE
QUALITY SYSTEMS ASSOCIATE	JOBTITLE
QUALITY WARRANTY MANAGER	JOBTITLE
QUANTITATIVE ANALYST	JOBTITLE
QUANTITATIVE DEVELOPER	JOBTITLE
QUANTITY SURVEYOR	JOBTITLE
RA LABELLING COORDINATOR	JOBTITLE
RADIATION THERAPIST	JOBTITLE
RADIOLOGIC TECHNOLOGIST	JOBTITLE
RADIOLOGY SPECIALIST	JOBTITLE
RADIOLOGY TECHNOLOGIST	JOBTITLE
RANK ASSISTANT	JOBTITLE
READING TEACHER	JOBTITLE
REAL ESTATE ADMINISTRATOR	JOBTITLE
REAL ESTATE ASSISTANT	JOBTITLE
REAL ESTATE BROKER	JOBTITLE
REAL ESTATE MANAGER	JOBTITLE
REAL ESTATE PARALEGAL	JOBTITLE
REAL ESTATE PROPERTY SALESPERSON	JOBTITLE
RECEIVABLE ASSOCIATE	JOBTITLE
RECEIVABLE SPECIALIST	JOBTITLE
RECERTIFICATION SPECIALIST	JOBTITLE
RECORDS ADMINISTRATOR	JOBTITLE
RECORDS SPECIALIST	JOBTITLE
RECREATION MANAGER	JOBTITLE
RECREATION SERVICES AIDE	JOBTITLE
RECREATION THERAPIST	JOBTITLE
RECREATIONAL THERAPIST	JOBTITLE
RECRUITER SALES MANAGEMENT TRAINEE	JOBTITLE
RECRUITING COORDINATOR	JOBTITLE
RECRUITMENT COORDINATOR 	JOBTITLE
RECRUITMENT MANAGER	JOBTITLE
RECRUITMENT OFFICER	JOBTITLE
RECRUITMENT SPECIALIST	JOBTITLE
REFERRAL SPECIALIST	JOBTITLE
REGIONAL BUSINESS DEVELOPMENT EXECUTIVE	JOBTITLE
REGIONAL BUSINESS DEVELOPMENT MANAGER	JOBTITLE
REGIONAL DIRECTOR	JOBTITLE
REGIONAL MANAGER	JOBTITLE
REGIONAL REMARKETING MANAGER	JOBTITLE
REGIONAL RISK MANAGER	JOBTITLE
REGIONAL SALES ACCOUNT EXECUTIVE	JOBTITLE
REGIONAL SALES DIRECTOR	JOBTITLE
REGIONAL SALES MANAGER	JOBTITLE
REGIONAL SALES REPRESENTATIVE	JOBTITLE
REGIONAL SALES SUPPORT MANAGER	JOBTITLE
REGISTERED CHARGE NURSE	JOBTITLE
REGISTERED CLIENT ASSOCIATE	JOBTITLE
REGISTERED DENTAL ASSISTANT	JOBTITLE
REGISTERED HEALTH INFORMATION TECHNICIAN	JOBTITLE
REGISTERED NURSE	JOBTITLE
REGISTERED PSYCHOLOGIST	JOBTITLE
REGISTRY ASSOCIATE	JOBTITLE
REGULAR TEACHER	JOBTITLE
REGULATORY AFFAIRS CONSULTANT	JOBTITLE
REGULATORY AFFAIRS MANAGER	JOBTITLE
REGULATORY DOCUMENTATION SCIENTIST	JOBTITLE
REHAB TECHNICIAN	JOBTITLE
REHABILITATION SPECIALIST	JOBTITLE
RELATIONS AND MARKETING COORDINATOR	JOBTITLE
RELATIONS COORDINATOR	JOBTITLE
RELATIONS MANAGER	JOBTITLE
RELATIONS REPRESENTATIVE	JOBTITLE
RELATIONS SPECIALIST	JOBTITLE
RELATIONSHIP BANKER	JOBTITLE
RELATIONSHIP COORDINATOR	JOBTITLE
RELATIONSHIP MANAGER	JOBTITLE
RELATIONSHIP SPECIALIST 	JOBTITLE
RELEASE COORDINATOR	JOBTITLE
RELEASE MANAGER	JOBTITLE
REMARKETING ADVISOR	JOBTITLE
RENTAL COMPLIANCE OFFICER	JOBTITLE
REPAIR TECHNICIAN	JOBTITLE
REPORTER	JOBTITLE
REPORTING ANALYST	JOBTITLE
REQUIREMENTS ANALYST	JOBTITLE
RESEARCH ANALYST	JOBTITLE
RESEARCH AND EVALUATION ASSOCIATE	JOBTITLE
RESEARCH AND POLICY OFFICER	JOBTITLE
RESEARCH ASSISTANT	JOBTITLE
RESEARCH ASSOCIATE	JOBTITLE
RESEARCH COORDINATOR	JOBTITLE
RESEARCH DATA SPECIALIST	JOBTITLE
RESEARCH FELLOW	JOBTITLE
RESEARCH MANAGER	JOBTITLE
RESEARCH OFFICER	JOBTITLE
RESEARCH SCIENTIST	JOBTITLE
RESEARCH SPECIALIST	JOBTITLE
RESEARCH TECHNICIAN	JOBTITLE
RESERVE TEACHER	JOBTITLE
RESIDENTIAL HOME SUPERVISOR	JOBTITLE
RESIDENTIAL LIFE COORDINATOR	JOBTITLE
RESIDENTIAL THERAPIST	JOBTITLE
RESOURCE ANALYST	JOBTITLE
RESOURCE COORDINATOR	JOBTITLE
RESOURCE MANAGER	JOBTITLE
RESOURCE SPECIALIST	JOBTITLE
RESOURCE TEACHER	JOBTITLE
RESOURCE TEACHER/ADMINISTRATIVE ASSISTANT	JOBTITLE
RESOURCES ADMINISTRATOR	JOBTITLE
RESOURCES ASSISTANT	JOBTITLE
RESOURCES COORDINATOR	JOBTITLE
RESOURCES DIRECTOR	JOBTITLE
RESOURCES MANAGER	JOBTITLE
RESOURCES SPECIALIST	JOBTITLE
RESPIRATORY CARE PRACTITIONER	JOBTITLE
RESPIRATORY PRACTITIONER	JOBTITLE
RESPIRATORY THERAPIST	JOBTITLE
RESPIRATORY THERAPY COORDINATOR	JOBTITLE
RESTAURANT ASSISTANT	JOBTITLE
RESTAURANT ASSISTANT MANAGER	JOBTITLE
RESTAURANT GENERAL MANAGER	JOBTITLE
RESTAURANT MANAGER	JOBTITLE
RETAIL ASSISTANT	JOBTITLE
RETAIL ASSISTANT STORE MANAGER	JOBTITLE
RETAIL ASSOCIATE	JOBTITLE
RETAIL CUSTOMER SERVICE MANAGER	JOBTITLE
RETAIL MANAGER	JOBTITLE
RETAIL MERCHANDISER	JOBTITLE
RETAIL OPERATIONS MANAGER	JOBTITLE
RETAIL SALES ASSOCIATE	JOBTITLE
RETAIL SALES CONSULTANT	JOBTITLE
RETAIL SALES REPRESENTATIVE	JOBTITLE
RETAIL STORE MANAGER	JOBTITLE
RETENTION SPECIALIST	JOBTITLE
RETIREMENT SPECIALIST	JOBTITLE
REVENUE ANALYST	JOBTITLE
REVENUE SPECIALIST	JOBTITLE
RF CONTRACTOR	JOBTITLE
RISK ANALYST	JOBTITLE
RISK MANAGEMENT COORDINATOR	JOBTITLE
RISK MANAGER	JOBTITLE
RN	JOBTITLE
RN FLOOR SUPERVISOR	JOBTITLE
RN II-LACTATION CONSULTANT	JOBTITLE
RN SCHOOL NURSE	JOBTITLE
RN STAFF NURSE	JOBTITLE
RN SUPERVISOR	JOBTITLE
ROUTE SERVICE SALES REPRESENTATIVE	JOBTITLE
SAAS PROJECT MANAGER	JOBTITLE
SAFETY COORDINATOR	JOBTITLE
SAFETY MANAGER	JOBTITLE
SAFETY OFFICER	JOBTITLE
SAFETY SPECIALIST	JOBTITLE
SAFETY TECHNICIAN	JOBTITLE
SALES ACCOUNT EXECUTIVE	JOBTITLE
SALES ACCOUNT MANAGER	JOBTITLE
SALES ADMINISTRATOR	JOBTITLE
SALES ANALYST	JOBTITLE
SALES AND OPERATIONS MANAGEMENT TRAINEE	JOBTITLE
SALES AND SERVICE ACCOUNT MANAGER	JOBTITLE
SALES ASSISTANT	JOBTITLE
SALES ASSOCIATE	JOBTITLE
SALES COORDINATOR	JOBTITLE
SALES CUSTOMER SERVICE SPECIALIST	JOBTITLE
SALES DEVELOPMENT REPRESENTATIVE	JOBTITLE
SALES DIRECTOR	JOBTITLE
SALES ENGINEER	JOBTITLE
SALES EXECUTIVE	JOBTITLE
SALES MANAGER	JOBTITLE
SALES MANAGER - RETAIL SALES MARKETING - MANAGER	JOBTITLE
SALES OPERATIONS ANALYST	JOBTITLE
SALES OPERATIONS PROJECT MANAGER	JOBTITLE
SALES REPRESENTATIVE	JOBTITLE
SALES SPECIALIST	JOBTITLE
SALES SUPERVISOR	JOBTITLE
SALES SUPPORT REPRESENTATIVE	JOBTITLE
SALESFORCE ADMINISTRATOR	JOBTITLE
SALESFORCE.COM ADMINISTRATOR	JOBTITLE
SALON MANAGER	JOBTITLE
SANITATION ASSISTANT	JOBTITLE
SAP INTEGRATION MANAGER	JOBTITLE
SCANNER SPECIALIST	JOBTITLE
SCHEDULING COORDINATOR	JOBTITLE
SCHEDULING MANAGER	JOBTITLE
SCHEDULING SPECIALIST	JOBTITLE
SCHOOL ADMINISTRATOR	JOBTITLE
SCHOOL AND FAMILY MENTAL HEALTH COUNSELOR	JOBTITLE
SCHOOL COUNSELOR	JOBTITLE
SCHOOL FACULTY	JOBTITLE
SCHOOL GUIDANCE COUNSELOR	JOBTITLE
SCHOOL LIBRARIAN 	JOBTITLE
SCHOOL NURSE	JOBTITLE
SCHOOL PSYCHOLOGIST	JOBTITLE
SCIENCE TEACHER	JOBTITLE
SCIENTIFIC STAFF ASSISTANT	JOBTITLE
SCREENING INVESTIGATOR	JOBTITLE
SD PERFORMANCE ANALYST	JOBTITLE
SECOND LANGUAGE TEACHER	JOBTITLE
SECTION ENGINEER	JOBTITLE
SECURITY ANALYST	JOBTITLE
SECURITY ASSISTANT	JOBTITLE
SECURITY GUARD	JOBTITLE
SECURITY LEAD	JOBTITLE
SECURITY MANAGER	JOBTITLE
SECURITY OFFICER	JOBTITLE
SECURITY SPECIALIST	JOBTITLE
SECURITY SUPERVISOR	JOBTITLE
SENIOR ACCOUNTANT	JOBTITLE
SENIOR ACCOUNTING ASSOCIATE	JOBTITLE
SENIOR ADMINISTRATIVE ASSISTANT	JOBTITLE
SENIOR ANALYST	JOBTITLE
SENIOR APPLICATION DEVELOPER	JOBTITLE
SENIOR ASSOCIATE	JOBTITLE
SENIOR AUDITOR	JOBTITLE
SENIOR BUSINESS INTELLIGENCE SPECIALIST	JOBTITLE
SENIOR BUYER	JOBTITLE
SENIOR CONSULTANT	JOBTITLE
SENIOR DATA ANALYST	JOBTITLE
SENIOR DIRECTOR	JOBTITLE
SENIOR DIRECTOR 	JOBTITLE
SENIOR ENGINEER	JOBTITLE
SENIOR EXECUTIVE	JOBTITLE
SENIOR FINANCIAL ANALYST	JOBTITLE
SENIOR HEALTH CARE PROJECT MANAGER	JOBTITLE
SENIOR JAVA DEVELOPER	JOBTITLE
SENIOR LECTURER	JOBTITLE
SENIOR MANAGER	JOBTITLE
SENIOR PLANNER	JOBTITLE
SENIOR PRINCIPAL	JOBTITLE
SENIOR PROJECT MANAGER	JOBTITLE
SENIOR PROPOSAL MANAGER	JOBTITLE
SENIOR PUBLIC POLICY ASSOCIATE	JOBTITLE
SENIOR SALES REPRESENTATIVE	JOBTITLE
SENIOR SAP BI/BW ANALYST	JOBTITLE
SENIOR SCIENTIST	JOBTITLE
SENIOR SOFTWARE DEVELOPER	JOBTITLE
SENIOR SOFTWARE ENGINEER	JOBTITLE
SENIOR SOLUTIONS CONSULTANT	JOBTITLE
SENIOR SPECIALIST	JOBTITLE
SENIOR SYSTEMS ENGINEER	JOBTITLE
SENIOR TAX ACCOUNTANT	JOBTITLE
SENIOR VICE PRESIDENT	JOBTITLE
SEO MANAGER	JOBTITLE
SEO SPECIALIST	JOBTITLE
SERVICE ACCOUNT MANAGER	JOBTITLE
SERVICE ADVISOR	JOBTITLE
SERVICE ANALYST	JOBTITLE
SERVICE ASSISTANT	JOBTITLE
SERVICE ASSOCIATE	JOBTITLE
SERVICE COORDINATOR	JOBTITLE
SERVICE DELIVERY MANAGER	JOBTITLE
SERVICE DESK ANALYST	JOBTITLE
SERVICE DESK TECHNICIAN	JOBTITLE
SERVICE DIRECTOR	JOBTITLE
SERVICE GUIDE	JOBTITLE
SERVICE MANAGER	JOBTITLE
SERVICE REPRESENTATIVE	JOBTITLE
SERVICE SALES REPRESENTATIVE	JOBTITLE
SERVICE SPECIALIST	JOBTITLE
SERVICE SUPERVISOR	JOBTITLE
SERVICE TECHNICIAN	JOBTITLE
SERVICES ADMINISTRATOR	JOBTITLE
SERVICES ASSISTANT	JOBTITLE
SERVICES ASSOCIATE	JOBTITLE
SERVICES COORDINATOR	JOBTITLE
SERVICES DIRECTOR	JOBTITLE
SERVICES MANAGER	JOBTITLE
SERVICES REPRESENTATIVE	JOBTITLE
SERVICES SPECIALIST	JOBTITLE
SERVICES SUPERVISOR	JOBTITLE
SERVICES TECHNICIAN	JOBTITLE
SESSIONAL INSTRUCTOR	JOBTITLE
SESSIONAL LECTURER	JOBTITLE
SHAREPOINT ADMINISTRATOR	JOBTITLE
SHIFT LEAD	JOBTITLE
SHIFT MANAGER	JOBTITLE
SHIFT SUPERVISOR 	JOBTITLE
SHIPPING RECEIVING CLERK	JOBTITLE
SHREDDING SPECIALIST	JOBTITLE
SIGN LANGUAGE INTERPRETER	JOBTITLE
SIGNALMAN	JOBTITLE
SIMULATION SPECIALIST	JOBTITLE
SITE ADMINISTRATOR	JOBTITLE
SITE COORDINATOR	JOBTITLE
SITE ENGINEER	JOBTITLE
SITE MANAGER	JOBTITLE
SITE MANAGER 	JOBTITLE
SITE OPERATIONS MANAGER	JOBTITLE
SITE SUPERVISOR 	JOBTITLE
SIU INVESTIGATOR	JOBTITLE
SKILLED LABORER	JOBTITLE
SKILLS INSTRUCTOR	JOBTITLE
SMARTPHONE TECHNICIAN	JOBTITLE
SOCIAL MEDIA SPECIALIST	JOBTITLE
SOCIAL SERVICE ASSISTANT	JOBTITLE
SOCIAL SERVICE SPECIALIST	JOBTITLE
SOCIAL SERVICES ASSISTANT	JOBTITLE
SOCIAL SERVICES DIRECTOR	JOBTITLE
SOCIAL STUDIES TEACHER	JOBTITLE
SOCIAL WORK UNIT SUPERVISOR	JOBTITLE
SOCIAL WORKER	JOBTITLE
SOFTWARE ARCHITECT	JOBTITLE
SOFTWARE DEVELOPER	JOBTITLE
SOFTWARE DEVELOPMENT ASSISTANT	JOBTITLE
SOFTWARE DEVELOPMENT ENGINEER	JOBTITLE
SOFTWARE DEVELOPMENT MANAGER	JOBTITLE
SOFTWARE ENGINEER	JOBTITLE
SOFTWARE SPECIALIST	JOBTITLE
SOFTWARE TRAINING SPECIALIST	JOBTITLE
SOLID QUALIFIED INBOUND LEAD	JOBTITLE
SOLUTION ARCHITECT	JOBTITLE
SOLUTIONS ARCHITECT	JOBTITLE
SOURCING MANAGER	JOBTITLE
SOURCING SPECIALIST	JOBTITLE
SPANISH TEACHER	JOBTITLE
SPECIAL EDUCATION FACILITATOR	JOBTITLE
SPECIAL EDUCATION INSTRUCTOR	JOBTITLE
SPECIAL EDUCATION TEACHER	JOBTITLE
SPECIAL EDUCATION TEACHER 	JOBTITLE
SPECIAL EDUCATION TEACHING SCHOOL PSYCHOLOGIST	JOBTITLE
SPECIAL EVENTS COORDINATOR	JOBTITLE
SPECIALIST - SPBA 	JOBTITLE
SPECIALIST ART	JOBTITLE
SPECIALIST ASSISTANT MANAGER	JOBTITLE
SPECIALIST HOSPITAL BILLING	JOBTITLE
SPECIALIST SUPERVISOR	JOBTITLE
SPECIALIZED FUNDING COORDINATOR	JOBTITLE
SPECIALTY DOCTOR	JOBTITLE
SPECIALTY ORDER ASSOCIATE	JOBTITLE
SPECIFICATION REPRESENTATIVE	JOBTITLE
SPEECH & LANGUAGE PATHOLOGIST	JOBTITLE
SPEECH AND LANGUAGE PATHOLOGIST	JOBTITLE
SPEECH LANGUAGE PATHOLOGIST	JOBTITLE
SPEECH THERAPIST	JOBTITLE
SPEECH-LANGUAGE PATHOLOGY ASSISTANT	JOBTITLE
SPORTS ADVISOR	JOBTITLE
SPORTS MARKETING REPRESENTATIVE	JOBTITLE
SPRAY TECHNICIAN	JOBTITLE
SQL DEVELOPER	JOBTITLE
SR FINANCIAL ANALYST	JOBTITLE
SR MANAGER	JOBTITLE
STAFF ACCOUNTANT	JOBTITLE
STAFF ASSISTANT	JOBTITLE
STAFF ASSOCIATE	JOBTITLE
STAFF DEVELOPMENT COORDINATOR	JOBTITLE
STAFF NURSE	JOBTITLE
STAFF OFFICER	JOBTITLE
STAFF PHARMACIST	JOBTITLE
STAFFING COORDINATOR	JOBTITLE
STARTUP EXCHANGE STEX LIAISON OFFICER	JOBTITLE
STATE FARM INDEPENDENT CONTRACTOR	JOBTITLE
STATE NURSE	JOBTITLE
STERILE PROCESSING TECHNICIAN	JOBTITLE
STEX LIAISON	JOBTITLE
STORE ASSOCIATE 	JOBTITLE
STORE DIRECTOR	JOBTITLE
STORE LEADER	JOBTITLE
STORE MANAGER	JOBTITLE
STRATEGIC ACCOUNT DIRECTOR	JOBTITLE
STRATEGIC ACCOUNT EXECUTIVE	JOBTITLE
STRATEGIC COMMUNICATIONS SPECIALIST	JOBTITLE
STRATEGIC SOURCING SPECIALIST	JOBTITLE
STRATEGIES PROJECT MANAGER	JOBTITLE
STRATEGY & PLANNING ANALYST	JOBTITLE
STRATEGY ANALYST	JOBTITLE
STRATEGY MANAGER	JOBTITLE
STRUCTURAL ENGINEER	JOBTITLE
STRUCTURAL MECHANIC	JOBTITLE
STUDENT ADMISSIONS REPRESENTATIVE	JOBTITLE
STUDENT ATHLETICS MANAGER	JOBTITLE
STUDENT NURSE	JOBTITLE
STUDENT OUTREACH ASSISTANT	JOBTITLE
STUDENT PROJECT ASSISTANT	JOBTITLE
STUDENT SERVICES SPECIALIST	JOBTITLE
STUDENT SYSTEMS ANALYST	JOBTITLE
STUDIO TECHNICAL MANAGER	JOBTITLE
SUBCONTRACT ADMINISTRATOR	JOBTITLE
SUBCONTRACTS ADMINISTRATOR	JOBTITLE
SUBSTANCE ABUSE COUNSELOR	JOBTITLE
SUBSTANCE USE DISORDER COUNSELOR	JOBTITLE
SUCCESS COORDINATOR	JOBTITLE
SUCCESS MANAGER	JOBTITLE
SUPERINTENDENT	JOBTITLE
SUPERVISORY BUDGET OFFICER	JOBTITLE
SUPPLEMENTAL HEALTH CARE REPRESENTATIVE	JOBTITLE
SUPPLIER QUALITY ENGINEER	JOBTITLE
SUPPLIER QUALITY WARRANTY MANAGER	JOBTITLE
SUPPLY CHAIN ANALYST	JOBTITLE
SUPPLY CHAIN COORDINATOR	JOBTITLE
SUPPLY CHAIN MANAGER	JOBTITLE
SUPPLY PLANNING COORDINATOR	JOBTITLE
SUPPLY TECHNICIAN	JOBTITLE
SUPPORT ANALYST	JOBTITLE
SUPPORT ASSISTANT	JOBTITLE
SUPPORT ASSOCIATE	JOBTITLE
SUPPORT CLERK 	JOBTITLE
SUPPORT COORDINATOR	JOBTITLE
SUPPORT MANAGER	JOBTITLE
SUPPORT REPRESENTATIVE	JOBTITLE
SUPPORT SPECIALIST	JOBTITLE
SUPPORT SPECIALIST 	JOBTITLE
SUPPORT STAFF CUSTODIAN	JOBTITLE
SUPPORT TEACHER	JOBTITLE
SUPPORT TECHNICIAN	JOBTITLE
SURFACING SPECIALIST	JOBTITLE
SURGICAL ASSISTANT	JOBTITLE
SURGICAL NURSE	JOBTITLE
SURGICAL TECHNICIAN	JOBTITLE
SURGICAL TECHNOLOGIST	JOBTITLE
SURVEILLANCE INVESTIGATOR	JOBTITLE
SURVEY SPECIALIST	JOBTITLE
SYS ANALYST	JOBTITLE
SYSTEM ADMINISTRATOR	JOBTITLE
SYSTEM ANALYST	JOBTITLE
SYSTEMS ADMINISTRATOR	JOBTITLE
SYSTEMS ANALYST	JOBTITLE
SYSTEMS ENGINEER	JOBTITLE
SYSTEMS MANAGER	JOBTITLE
SYSTEMS SPECIALIST	JOBTITLE
TACO BELL ASSISTANT	JOBTITLE
TACO BELL ASSISTANT GENERAL MANAGER	JOBTITLE
TACTICAL SUPPLY PLANNING COORDINATOR	JOBTITLE
TALENT ACQUISITION MANAGER	JOBTITLE
TALENT ACQUISITION RECRUITER	JOBTITLE
TALENT ACQUISITION SPECIALIST	JOBTITLE
TALENT REPRESENTATIVE	JOBTITLE
TALENT SPECIALIST 	JOBTITLE
TASK DISABILITIES INCLUSION SPECIALIST	JOBTITLE
TAX ACCOUNTANT	JOBTITLE
TAX ANALYST	JOBTITLE
TAX MANAGER	JOBTITLE
TBS BEHAVIOR COUNSELOR	JOBTITLE
TEACHER 	JOBTITLE
TEACHER - SPECIAL EDUCATION 	JOBTITLE
TEACHER ASSISTANT	JOBTITLE
TEACHER ASSISTANT PART-TIME	JOBTITLE
TEACHER K-12	JOBTITLE
TEACHER K-5	JOBTITLE
TEACHER -LRB-	JOBTITLE
TEACHER OR ADMINISTRATOR	JOBTITLE
TEACHER OR ADMINISTRATOR 	JOBTITLE
TEACHER 'S ASSISTANT	JOBTITLE
TEACHER SALARY 	JOBTITLE
TEACHER SPECIALIST	JOBTITLE
TEACHER/ADMINISTRATIVE ASSISTANT	JOBTITLE
TEACHING FELLOW	JOBTITLE
TEAM ADMINISTRATIVE ASSISTANT	JOBTITLE
TEAM ASSISTANT	JOBTITLE
TEAM COORDINATOR	JOBTITLE
TEAM LEAD	JOBTITLE
TEAM LEADER	JOBTITLE
TEAM MANAGER	JOBTITLE
TECH ASSOCIATE	JOBTITLE
TECHNICAL ANALYST	JOBTITLE
TECHNICAL ARCHITECT	JOBTITLE
TECHNICAL ASSISTANT	JOBTITLE
TECHNICAL AUTHOR	JOBTITLE
TECHNICAL CUSTOMER SERVICE CALL CENTER REPRESENTATIVE	JOBTITLE
TECHNICAL INSIDE SALES REPRESENTATIVE	JOBTITLE
TECHNICAL LEAD	JOBTITLE
TECHNICAL LEADER	JOBTITLE
TECHNICAL MANAGER	JOBTITLE
TECHNICAL PROJECT MANAGER	JOBTITLE
TECHNICAL SALES SPECIALIST	JOBTITLE
TECHNICAL SERVICE ACCOUNT MANAGER	JOBTITLE
TECHNICAL SPECIALIST	JOBTITLE
TECHNICAL SUPPORT REPRESENTATIVE	JOBTITLE
TECHNICAL WRITER	JOBTITLE
TECHNICIAN ASSISTANT/RECEPTIONIST 	JOBTITLE
TECHNICIAN II	JOBTITLE
TECHNICIAN JOB	JOBTITLE
TECHNICIAN RPA/UAS	JOBTITLE
TECHNICIAN RPA/UAS 	JOBTITLE
TECHNICIAN TRAINING	JOBTITLE
TECHNICIAN TRAINING PROGRAM	JOBTITLE
TECHNOLOGY SALES REPRESENTATIVE	JOBTITLE
TECHNOLOGY SPECIALIST	JOBTITLE
TELEMETRY TECHNICIAN	JOBTITLE
TERRITORY BUSINESS MANAGER	JOBTITLE
TERRITORY MANAGER	JOBTITLE
TERRITORY SALES REPRESENTATIVE	JOBTITLE
TEST PILOT AND FLIGHT ANALYST	JOBTITLE
TEST TECHNICIAN	JOBTITLE
TESTING AND COMMISSIONING MANAGER	JOBTITLE
TEXAS STATE BOARD OF PHYSICIAN ASSISTANT	JOBTITLE
THERAPIST ASSISTANT	JOBTITLE
THERAPIST TO PROVIDENCE	JOBTITLE
THERAPY ASSISTANT	JOBTITLE
THERAPY SERVICES DIRECTOR	JOBTITLE
TIME ADJUSTER	JOBTITLE
TIME CAPTIONER	JOBTITLE
TIME EVENT & ADMINISTRATIVE ASSISTANT	JOBTITLE
TOUR COORDINATOR	JOBTITLE
TRACK MAINTENANCE LABORER	JOBTITLE
TRAINING AND EDUCATION SPECIALIST	JOBTITLE
TRAINING DIRECTOR	JOBTITLE
TRAINING MANAGER	JOBTITLE
TRAINING SPECIALIST	JOBTITLE
TRANSACTION MANAGER	JOBTITLE
TRANSITION SPECIALIST	JOBTITLE
TRANSITIONAL CARE MANAGER	JOBTITLE
TRANSITIONS SOCIAL WORKER	JOBTITLE
TRANSMISSION TECHNICIAN	JOBTITLE
TRANSMISSION TECHNICIANS	JOBTITLE
TRANSPORTATION COORDINATOR	JOBTITLE
TRANSPORTATION MANAGER	JOBTITLE
TRANSPORTATION PLANNER	JOBTITLE
TRANSPORTATION WORKER	JOBTITLE
TRAVEL AND TRANSPORTATION COORDINATOR	JOBTITLE
TRAVEL NURSE	JOBTITLE
TREATMENT SPECIALIST	JOBTITLE
TRUCK WELDER	JOBTITLE
TRUSTS AND FOUNDATIONS MANAGER	JOBTITLE
TUMOR REGISTRY COORDINATOR	JOBTITLE
ULTRSOUND TECHNOLOGIST	JOBTITLE
UNARMED SECURITY GUARD	JOBTITLE
UNDERWRITING ASSISTANT	JOBTITLE
UNIT MANAGER	JOBTITLE
URBAN STRATEGIES PROJECT MANAGER	JOBTITLE
UTILITIES TECHNICIAN	JOBTITLE
UTILIZATION CARE MANAGER	JOBTITLE
VALID CALIFORNIA CLASS C DRIVER	JOBTITLE
VARIABLE HOURS LECTURER	JOBTITLE
VASCULAR TECHNOLOGIST	JOBTITLE
VETERINARY ASSISTANT	JOBTITLE
VETERINARY TECHNICIAN	JOBTITLE
VICE PRESIDENT	JOBTITLE
VICE PRESIDENT/CHIEF OPERATING OFFICER	JOBTITLE
VISION REHABILITATION THERAPIST	JOBTITLE
VISITING NURSE	JOBTITLE
VISITOR PROGRAMS ASSISTANT	JOBTITLE
VISUAL MERCHANDISER	JOBTITLE
VOCATIONAL NURSE	JOBTITLE
VOCATIONAL REHABILITATION COUNSELOR	JOBTITLE
VOLUNTEER COORDINATOR	JOBTITLE
VOLUNTEER MANAGER	JOBTITLE
WALPOLE PARK MANAGER	JOBTITLE
WAREHOUSE ASSOCIATE	JOBTITLE
WAREHOUSE MANAGER	JOBTITLE
WAREHOUSE SUPERVISOR	JOBTITLE
WAREHOUSE WORKER	JOBTITLE
WARRANTY MANAGER	JOBTITLE
WC SPECIALIST	JOBTITLE
WEB DESIGN DEVELOPER	JOBTITLE
WEB DESIGNER	JOBTITLE
WEB DEVELOPER	JOBTITLE
WEB GRAPHIC DESIGNER	JOBTITLE
WEBMASTER	JOBTITLE
WEBSITE DESIGN	JOBTITLE
WELDING ENGINEER	JOBTITLE
WELLNESS ASSOCIATE	JOBTITLE
WELLNESS SPECIALIST	JOBTITLE
WIND MOBILE	JOBTITLE
WIRING TECHNICIAN	JOBTITLE
WORK LIFE COORDINATOR	JOBTITLE
WORKERS COMPENSATION SPECIALIST	JOBTITLE
WORKFORCE MANAGEMENT SPECIALIST	JOBTITLE
WOTC ANALYST	JOBTITLE
WOUND CARE COORDINATOR	JOBTITLE
WRITER/QA ANALYST	JOBTITLE
X-RAY TECHNOLOGIST	JOBTITLE
YOUTH & FAMILY SPECIALIST	JOBTITLE
YOUTH AND FAMILY SPECIALIST	JOBTITLE
"ANALYST , INFORMATION TECHNOLOGY"	JOBTITLE
"ANALYST , SUPERVISOR"	JOBTITLE
CERTIFIED BEHAVIOR ANALYST	JOBTITLE
CERTIFIED DIETARY MANAGER	JOBTITLE
CERTIFIED NURSING ASSISTANT	JOBTITLE
CERTIFIED PAYROLL MANAGER	JOBTITLE
CERTIFIED PHARMACY TECHNICIAN	JOBTITLE
CERTIFIED TEACHER 	JOBTITLE
"DIRECTOR , ADULT SPMI"	JOBTITLE
"DIRECTOR , CHARITABLE INVESTMENTS"	JOBTITLE
"DIRECTOR , DRUG DEVELOPMENT"	JOBTITLE
"DIRECTOR , HUMAN RESOURCES CALL"	JOBTITLE
"DIRECTOR , HUMAN RESOURCES CALL CENTER"	JOBTITLE
"DIRECTOR , LABORATORY"	JOBTITLE
"DIRECTOR , LABORATORY SERVICES"	JOBTITLE
"DIRECTOR , MEDICAL CLINIC"	JOBTITLE
"DIRECTOR , PHILANTHROPIC RESOURCES"	JOBTITLE
"EXAMINER , IELTS TEST"	JOBTITLE
"MANAGER , ADVANCED PRACTICE PROVIDER"	JOBTITLE
"MANAGER , BUSINESS DEVELOPMENT"	JOBTITLE
"MANAGER , CREATIVE SERVICES"	JOBTITLE
"MANAGER , CUSTOMER SUCCESS"	JOBTITLE
"MANAGER , ELECTRICAL ENGINEERING"	JOBTITLE
"MANAGER , ELECTRICAL ENGINEERING , INFRASTRUCTURE FACILITIES"	JOBTITLE
"MANAGER , INFORMATION TECHNOLOGY"	JOBTITLE
"MANAGER , INTERNAL AUDIT"	JOBTITLE
"MANAGER , MAINTENANCE"	JOBTITLE
"MANAGER , PATIENT CARE NURSING"	JOBTITLE
"MANAGER , PROGRAM OPERATIONS"	JOBTITLE
"MANAGER , TECHNICAL SERVICES"	JOBTITLE
"TEACHER , ESL"	JOBTITLE
"TEACHER , HISTORY"	JOBTITLE
"TEACHER , HISTORY "	JOBTITLE
"TEACHER , HISTORY 6TH GRADE"	JOBTITLE
"TEACHER , MATH"	JOBTITLE
"TEACHER , SPECIAL EDUCATION"	JOBTITLE
"TEACHER , SPECIAL EDUCATION "	JOBTITLE
"TEACHER , SPECIAL EDUCATION RESOURCE"	JOBTITLE
"TEACHER OR ADMINISTRATOR , GCU "	JOBTITLE
"TECHNICIAN ,"	JOBTITLE
AAS DEGREE	LDEGREEEDU
ACCREDITATION	LDEGREEEDU
AS DEGREE	LDEGREEEDU
ASSOCIATE DEGREE	LDEGREEEDU
ASSOCIATE DEGREE IN	LDEGREEEDU
ASSOCIATE IN SCIENCE	LDEGREEEDU
ASSOCIATE 'S DEGREE	LDEGREEEDU
ASSOCIATE 'S OR BACHELOR 'S DEGREE	LDEGREEEDU
ASSOCIATES DEGREE	LDEGREEEDU
ASSOCIATES OR BACHELORS DEGREE	LDEGREEEDU
CERTIFICATE	LDEGREEEDU
CERTIFICATION	LDEGREEEDU
CERTIFICATIONS	LDEGREEEDU
CERTIFIED	LDEGREEEDU
DIPLOMA	LDEGREEEDU
LICENSE	LDEGREEEDU
LICENSED	LDEGREEEDU
LICENSURE	LDEGREEEDU
BURNABY	LOCATION
MAKE BELIEVE TOWN	LOCATION
MY BIG FOOT	LOCATION
GENERAL	O
ACCOUNTING	SKILL
ACHIEVEMENT IN FAMILY RESEARCH STUDIES	SKILL
ADMINISTRATIVE MEDICAL ASSISTING	SKILL
ADN	SKILL
ADULT CHILD INFANT CPR	SKILL
ADULT EDUCATION	SKILL
ADVANCED CARDIAC LIFE SUPPORT	SKILL
ADVANCED MANAGEMENT	SKILL
ADVANCED MEDICAL BILLING	SKILL
ADVANCED STUDIES IN TAXATION	SKILL
ADVERTISING	SKILL
AFRICAN AMERICAN STUDIES	SKILL
AIR CONDITIONING	SKILL
AIR CONDITIONING - COMMERCIAL REFRIGERATION	SKILL
AIR CONDITIONING - DOMESTIC REFRIGERATION	SKILL
AIR CONDITIONING - HEATING	SKILL
AIR CONDITIONING AND REFRIGERATION	SKILL
ALTERNATIVE FUEL VEHICLE TECHNOLOGY	SKILL
AMERICAN HEART ASSOCIATION	SKILL
AMERICAN MEDICAL TECHNOLOGIST	SKILL
AMERICAN SOCIETY OF CLINICAL PATHOLOGISTS	SKILL
AMT	SKILL
ANIMATION	SKILL
ANTHROPOLOGY	SKILL
AP CP	SKILL
APPLIED SENSORY AND CONSUMER SCIENCE	SKILL
APPROPRIATE FIELD	SKILL
ARCHAEOLOGY	SKILL
ARCHITECTURAL CAD	SKILL
ARCHITECTURE	SKILL
ART	SKILL
ART (STUDIO)	SKILL
ART HISTORY	SKILL
ARTS	SKILL
ASIAN STUDIES	SKILL
ASSURANCE AND DIGITAL FORENSICS	SKILL
AUTISM SPECTRUM DISORDERS	SKILL
AUTOMOTIVE BODY RECONSTRUCTION TECHNOLOGY	SKILL
AUTOMOTIVE BODY REPAINTING TECHNOLOGY	SKILL
AUTOMOTIVE CHASSIS MAINTENANCE	SKILL
AUTOMOTIVE FUEL MANAGEMENT TECHNOLOGY	SKILL
AUTOMOTIVE MAINTENANCE	SKILL
AUTOMOTIVE TECHNOLOGY	SKILL
AVIATION MANAGEMENT OPTION	SKILL
BACKFLOW TESTER LICENSE	SKILL
BAKING AND PASTRY ARTS	SKILL
BANKING	SKILL
BASIC & ADVANCED TRAVEL	SKILL
BASIC NURSING ASSISTANT	SKILL
BASIC POLICE ACADEMY	SKILL
BEHAVIORAL OR SOCIAL SCIENCES	SKILL
BEHAVIORAL SCIENCE	SKILL
BEHAVIORAL SCIENCES	SKILL
BEHAVIOURAL OR SOCIAL SCIENCES	SKILL
BEHAVIOURAL SCIENCE	SKILL
BEHAVIOURAL SCIENCES	SKILL
BIOCHEMISTRY	SKILL
BIOLOGICAL STUDIES	SKILL
BIOLOGY	SKILL
BIOMEDICAL	SKILL
BIOMEDICAL ENGINEERING	SKILL
BIOMEDICAL ENGINEERING DEGREE	SKILL
BIOTECHNOLOGY	SKILL
BIOTECHNOLOGY PROJECT MANAGEMENT	SKILL
BOOKKEEPING	SKILL
BROADCAST &ELECTRONIC MEDIA: BROADCAST	SKILL
BROADCASTING	SKILL
BUILDING CONSTRUCTION TECHNOLOGY	SKILL
BUILDING ENERGY TECHNOLOGIES	SKILL
BUILDING INSPECTION TECHNOLOGY	SKILL
BUSINESS	SKILL
BUSINESS ADMINISTRATION	SKILL
BUSINESS ADMINISTRATION - GENERAL BUSINESS	SKILL
BUSINESS COMMUNICATION	SKILL
BUSINESS COMMUNICATIONS	SKILL
BUSINESS DISCIPLINE	SKILL
BUSINESS ENTREPRENEURSHIP	SKILL
BUSINESS INFO PROCESSING	SKILL
BUSINESS INFORMATION SYSTEMS	SKILL
BUSINESS INTELLIGENCE	SKILL
BUSINESS INTELLIGENCE AND DATA WAREHOUSING	SKILL
BUSINESS INTELLIGENCE AND KNOWLEDGE MANAGEMENT SYSTEMS	SKILL
BUSINESS LOGISTICS	SKILL
BUSINESS MANAGEMENT	SKILL
BUSINESS MANAGEMENT PROGRAM	SKILL
BUSINESS MANAGEMENT/LEADERSHIP	SKILL
BUSINESS MARKETING	SKILL
BUSINESS OPERATIONS SUPPORT AND SECRETARIAL SERVICES	SKILL
BUSINESS PRINCIPLES	SKILL
BUSINESS PROCESS OPTIMIZATION	SKILL
BUSINESS/ECONOMICS	SKILL
C# PROGRAMMING	SKILL
C. A. M. LICENSE	SKILL
C/C++ PROGRAMMING	SKILL
CADTECHNOLOGY	SKILL
CAM LICENSE	SKILL
CAREER ADVISING	SKILL
CAREER AND LIFE PLANNING	SKILL
CARING IN THE HEALTH PROFESSIONS	SKILL
CASINO MANAGEMENT	SKILL
CG ART	SKILL
CG DESIGN	SKILL
CGMBS	SKILL
CHEMICAL ENGINEERING	SKILL
CHEMICAL LABORATORY TECHNOLOGY	SKILL
CHILD DEVELOPMENT	SKILL
CHINESE	SKILL
CHINESE (MANDARIN)	SKILL
CHOREOGRAPHY	SKILL
CINEMATOGRAPHY	SKILL
CIVIL ENGINEERING	SKILL
CIVIL SITEWORK CONSTRUCTION	SKILL
CLASSICS	SKILL
CLINICAL & APPLIED HYPNOSIS	SKILL
CLINICAL COMPETENCE	SKILL
CLINICAL COMPETENCY	SKILL
CLINICAL RESEARCH CONDUCT AND MANAGEMENT	SKILL
CLINICAL RESEARCH INFORMATICS GRADUATE CERTIFICATE	SKILL
CLINICAL TRIALS ADMINISTRATION	SKILL
CLINICAL TRIALS: MEDICAL DEVICE AND DRUG DEVELOPMENT	SKILL
CLS	SKILL
CLS / MT	SKILL
COGNITIVE PSYCHOLOGY	SKILL
COGNITIVE SCIENCE	SKILL
COLLEGE ADMISSIONS COUNSELING	SKILL
COLLISION TECHNOLOGY	SKILL
COMMERCE	SKILL
COMMERCIAL PHOTOGRAPHY	SKILL
COMMUNICATION STUDIES	SKILL
COMMUNICATION SYSTEMS ENGINEERING	SKILL
COMMUNICATION SYSTEMS GRADUATE CERTIFICATE	SKILL
COMMUNICATIONS	SKILL
COMMUNICATIONS SYSTEMS ENGINEERING	SKILL
COMMUNICATIONS TECHNOLOGY	SKILL
COMMUNITY COLLEGE FACULTY PREPARATION	SKILL
COMPARATIVE RELIGION	SKILL
COMPLETION FOR LABORATORY ASSISTING	SKILL
COMPLETION IN TRAINING AND DEVELOPMENT	SKILL
COMPLETION OF LABORATORY ASSISTING	SKILL
COMPREHENSIVE EVIDENCE BASED COACHING	SKILL
COMPUTER & NETWORK FORENSICS	SKILL
COMPUTER ACCOUNTING	SKILL
COMPUTER APPLICATIONS AND OFFICE TECHNOLOGIES	SKILL
COMPUTER BUSINESS APPLICATIONS	SKILL
COMPUTER BUSINESS TECHNOLOGY ADMINISTRATIVE ASSISTANT	SKILL
COMPUTER ENGINEERING	SKILL
COMPUTER FORENSICS	SKILL
COMPUTER FUNDAMENTALS	SKILL
COMPUTER INFORMATION SYSTEMS	SKILL
COMPUTER NETWORK ADMINISTRATION & SECURITY	SKILL
COMPUTER NETWORK AND INFORMATION SYSTEM SECURITY	SKILL
COMPUTER NETWORK AND SECURITY MANAGEMENT	SKILL
COMPUTER NETWORK MANAGEMENT	SKILL
COMPUTER NETWORK SECURITY	SKILL
COMPUTER NETWORKING AND SYSTEM ADMINISTRATION	SKILL
COMPUTER NUMERIC CONTROL MACHINING	SKILL
COMPUTER PROFICIENCY ONLINE	SKILL
COMPUTER PROGRAMMING	SKILL
COMPUTER SCIENCE	SKILL
COMPUTER SCIENCE INFORMATION TECHNOLOGY	SKILL
COMPUTER SCIENCE/MIS	SKILL
COMPUTER SCIENCES	SKILL
COMPUTER SECURITY AND FORENSIC INVESTIGATION	SKILL
COMPUTER TECHNOLOGY	SKILL
COMPUTER WEB SUPPORT AND ADMINISTRATION	SKILL
COMPUTER-AIDED DESIGN	SKILL
COMPUTER-AIDED DRAFTING TECHNOLOGY	SKILL
CONCRETE MASONRY	SKILL
CONSERVATION POLICY	SKILL
CONSTRUCTION CARPENTRY	SKILL
CONSTRUCTION CRAFT LABORER	SKILL
CONSTRUCTION ESTIMATING	SKILL
CONSTRUCTION MANAGEMENT	SKILL
CONSTRUCTION PRACTICES	SKILL
CONSTRUCTION SUPERVISORY SERIES	SKILL
COPYEDITING	SKILL
CORRECTIONS	SKILL
COSMETOLOGY	SKILL
COUNSELING	SKILL
CRIMINAL JUSTICE	SKILL
CRIMINAL JUSTICE ADMINISTRATION	SKILL
CRIMINOLOGY	SKILL
CRIMINOOLOGY	SKILL
CRITICAL THINKING	SKILL
CULINARY ARTS	SKILL
CYBER SECURITY	SKILL
DANCE	SKILL
DATA MINING	SKILL
DATA MINING AND APPLICATIONS GRADUATE CERTIFICATE	SKILL
DATA SCIENCE	SKILL
DATABASE APPLICATION DEVELOPMENT FOR MICROSOFT ACCESS	SKILL
DATABASE MANAGEMENT	SKILL
DENTAL ASSISTING	SKILL
DENTAL HYGIENE	SKILL
DER CERTIFICATION	SKILL
DESIGN	SKILL
DESIGN STUDIES	SKILL
DEVICE SOFTWARE ENGINEERING	SKILL
DIESEL TECHNOLOGY	SKILL
DIET THERAPY	SKILL
DIETETIC TECHNICIAN PROGRAM	SKILL
DIGITAL AUDIO	SKILL
DIGITAL COMMUNICATION NETWORKS	SKILL
DIGITAL JOURNALISM	SKILL
DIGITAL MEDIA	SKILL
DIGITAL MULTIMEDIA DESIGN	SKILL
DIGITAL MULTIMEDIA DESIGN-INTERACTIVE DESIGN AND DEVELOPMENT	SKILL
DIGITAL SIGNAL PROCESSING	SKILL
DIGITAL VIDEO	SKILL
DSP SYSTEMS ENGINEERING	SKILL
DUTY AREA 5 ELECTRICAL SYSTEM	SKILL
EARLY CHILDHOOD	SKILL
EARLY CHILDHOOD EDUCATION	SKILL
EARLY CHILDHOOD SPECIAL EDUCATION	SKILL
EARTH SYSTEM SCIENCE AND ENVIRONMENTAL	SKILL
ECE	SKILL
ECOLOGY	SKILL
ECONOMICS	SKILL
EDITING 	SKILL
EDUCATION	SKILL
EDUCATION STUDIES	SKILL
EDUCATIONAL TECHNOLOGY	SKILL
EFFECTIVE COMMUNICATION TECHNIQUES FOR TEACHERS	SKILL
E-LEARNING AND ONLINE TEACHING	SKILL
E-LEARNING INSTRUCTIONAL DESIGN	SKILL
ELECTRIC ENGINEERING	SKILL
ELECTRICAL CONSTRUCTION TECHNOLOGY	SKILL
ELECTRICAL ENGINEERING	SKILL
ELECTRICAL OR MECHANICAL ENGINEERING	SKILL
ELECTRICAL POWER SYSTEMS & INSTRUMENTATION	SKILL
ELECTRICIAN 'S LICENSE	SKILL
ELECTRO-MECHANICAL ENGINEERING	SKILL
ELECTRONIC ENGINEERING	SKILL
ELECTRONIC MUSIC	SKILL
ELECTRONICS TECHNOLOGY	SKILL
ELEMENTARY EDUCATION	SKILL
EMBEDDED COMPUTER ENGINEERING	SKILL
EMBEDDED COMPUTER SOFTWARE	SKILL
EMBEDDED SYSTEMS ENGINEERING	SKILL
EMERGENCY AND DISASTER MANAGEMENT	SKILL
EMERGENCY DEPARTMENT NURSING	SKILL
EMERGENCY MANAGEMENT	SKILL
ENERGY RESOURCE MANAGEMENT	SKILL
ENGINEERING	SKILL
ENGINEERING AND PHYSICS	SKILL
ENGINEERING MANAGEMENT	SKILL
ENGINEERING OPTION	SKILL
ENGINEERING RELATED DISCIPLINE	SKILL
ENGINEERING SCIENCE:	SKILL
ENGLISH	SKILL
ENGLISH EDUCATION	SKILL
ENGLISH LANGUAGE AND LITERATURE	SKILL
ENGLISH LITERATURE ANALYSIS	SKILL
ENGLISH WRITING SKILLS	SKILL
ENGNEERING RELATED FIELD	SKILL
ENROLLMENT MANAGEMENT	SKILL
ENTERPRISE DEVELOPMENT USING JAVA TECHNOLOGIES	SKILL
ENTREPRENEURSHIP	SKILL
ENVIRONMENTAL BIOLOGY	SKILL
ENVIRONMENTAL ENGINEERING	SKILL
ENVIRONMENTAL HEALTH SCIENCES	SKILL
ENVIRONMENTAL MANAGEMENT	SKILL
ENVIRONMENTAL SCIENCE	SKILL
ENVIRONMENTAL SUSTAINABILITY	SKILL
ENVIRONMENTAL TECHNOLOGY	SKILL
EPIDEMIOLOGY	SKILL
EQUINE EVENT MANAGEMENT	SKILL
ESL	SKILL
ESTATE PLANNING	SKILL
EU PUBLIC PROCUREMENT	SKILL
EVIDENCE BASED COACHING FOR EDUCATION LEADERSHIP	SKILL
EVIDENCE BASED COACHING FOR ORGANIZATION LEADERSHIP	SKILL
EVIDENCE BASED COACHING FOR PERSONAL DEVELOPMENT	SKILL
EXERCISE NUTRITION	SKILL
FACILITIES MANAGEMENT	SKILL
FACTORY AUTOMATION	SKILL
FACULTY PREPARATION	SKILL
FAMILY CHILDCARE BUSINESS	SKILL
FAMILY HEALTH	SKILL
FEMINIST STUDIES	SKILL
FILM	SKILL
FINANCE	SKILL
FINANCE/ACCOUNTING	SKILL
FINANCIAL LITERACY	SKILL
FINANCIAL PLANNING	SKILL
FINANCIAL PLANNING AND ANALYSIS	SKILL
FINANCIAL SERVICES	SKILL
FINE ARTS	SKILL
FINE ARTS PHOTOGRAPHY OPTION	SKILL
FIRE SCIENCE MANAGEMENT	SKILL
FIRE SERVICE OPERATIONS	SKILL
FIRE TECHNOLOGY	SKILL
FOOD SAFETY	SKILL
FOOD SANITATION	SKILL
FOOD SCIENCE DIPLOMA	SKILL
FOOD SCIENCES	SKILL
FOOD SERVICE MANAGEMENT	SKILL
FOOD SERVICE SANITATION - RECERTIFICATION	SKILL
FOODSERVICE MANAGEMENT	SKILL
FORENSIC ACCOUNTING	SKILL
FORENSIC NURSING	SKILL
FORKLIFT OPERATION AND SAFETY	SKILL
FRACTIONS IN MATHEMATICS	SKILL
FREIGHT BROKER TRAINING	SKILL
FRENCH	SKILL
FRENCH EDUCATION	SKILL
GAS METAL ARC WELDING	SKILL
GATE PROGRAMS	SKILL
GENDER STUDIES	SKILL
GENERAL ACCOUNTING	SKILL
GENERAL BUSINESS	SKILL
GENERAL CONTRACTORS LICENSE	SKILL
GENERAL MAINTENANCE WORKER LICENSE	SKILL
GENERAL MULTIMEDIA	SKILL
GENERAL OFFICE	SKILL
GENERAL SCIENCE EDUCATION	SKILL
GENETIC COUNSELING	SKILL
GEOGRAPHIC INFORMATION SYSTEMS	SKILL
GEOGRAPHY	SKILL
GEOLOGY	SKILL
GEOMATICS	SKILL
GEOMATICS ENGINEERING	SKILL
GEOMETRY IN MATHEMATICS	SKILL
GERMAN	SKILL
GERONTOLOGY	SKILL
GIFTED AND TALENTED EDUCATION	SKILL
GLOBAL STUDIES	SKILL
GLOBAL TEACHER STUDIES AND PREPARATION: INTERNATIONAL BACCALAUREATE PROGRAM	SKILL
GOOGLE APPLICATIONS FOR BUSINESS	SKILL
GOVERNMENTAL ACCOUNTING	SKILL
GRANT WRITING	SKILL
GRAPHIC DESIGN	SKILL
GRAPHIC PRODUCTION	SKILL
GRAPHICS	SKILL
GREEN BUILDING CONSTRUCTION	SKILL
GREEN DEVELOPMENT AND PROPERTY MANAGEMENT	SKILL
GREEN ENERGY MANAGEMENT	SKILL
GROWTH STRATEGIES FOR BUSINESS	SKILL
HEALTH & WELLNESS COACHING	SKILL
HEALTH ADMINISTRATION	SKILL
HEALTH CARE	SKILL
HEALTH CARE ADMINISTRATION	SKILL
HEALTH CARE MANAGEMENT	SKILL
HEALTH EDUCATION	SKILL
HEALTH GUIDELINES FOR AVOIDING INFECTIOUS DISEASES	SKILL
HEALTH INFORMATICS	SKILL
HEALTH INFORMATION CODING SPECIALIST	SKILL
HEALTH INFORMATION MANAGEMENT	SKILL
HEALTH INFORMATION TECHNOLOGY	SKILL
HEALTH POLICY	SKILL
HEALTH SCIENCE	SKILL
HEALTH SCIENCES	SKILL
HEALTH SERVICES ADMINISTRATION	SKILL
HEALTHCARE	SKILL
HEALTHCARE ADMINISTRATION	SKILL
HEALTHCARE INFORMATION TECHNOLOGY	SKILL
HEALTHCARE MANAGEMENT	SKILL
HEALTHCARE MANAGEMENT OPTION	SKILL
HEALTHY LIVING	SKILL
HIGHWAY CONSTRUCTION CAREERS TRAINING PROGRAM	SKILL
HISTORY	SKILL
HISTORY OF ART	SKILL
HISTORY OPTION	SKILL
HOME BUSINESS	SKILL
HOMELAND SECURITY	SKILL
HORTICULTURE	SKILL
HORTICULTURE: FLORISTRY	SKILL
HOSPITALITY AND CASINO MANAGEMENT	SKILL
HOSPITALITY MANAGEMENT	SKILL
HOTEL FRONT DESK AND BACK OFFICE OPERATIONS	SKILL
HOW TO CREATE YOUR FIRST WEBSITE	SKILL
HR	SKILL
HUMAN DEVELOPMENT AND FAMILY STUDIES	SKILL
HUMAN GEOGRAPHY	SKILL
HUMAN RESOURCE	SKILL
HUMAN RESOURCES	SKILL
HUMAN RESOURCES MANAGEMENT	SKILL
HUMAN SERVICES	SKILL
HUMAN SERVICES: MENTAL HEALTH?	SKILL
HVAC	SKILL
HVAC TECHNOLOGY	SKILL
INDUSTRIAL DESIGN	SKILL
INDUSTRIAL ELECTRONICS	SKILL
INDUSTRIAL ELECTRONICS TECHNICAL CERTIFICATION	SKILL
INDUSTRIAL ENGINEERING	SKILL
INDUSTRIAL MAINTENANCE	SKILL
INDUSTRIAL PSYCHOLOGY	SKILL
INDUSTRIAL TECHNOLOGY WELDING	SKILL
INDUSTRIAL WELDING	SKILL
INFORMATION MANAGEMENT	SKILL
INFORMATION SCIENCE	SKILL
INFORMATION SECURITY AND DIGITAL ASSURANCE MANAGEMENT	SKILL
INFORMATION SECURITY MANAGER	SKILL
INFORMATION STUDIES	SKILL
INFORMATION SYSTEMS	SKILL
INFORMATION SYSTEMS SECURITY	SKILL
INFORMATION TECHNOLOGY MANAGEMENT	SKILL
INPATIENT AND OUTPATIENT MEDICAL CODING AND BILLING	SKILL
INSTRUCTIONAL DESIGN	SKILL
INSTRUCTIONAL MULTI-MEDIA	SKILL
INSTRUCTIONAL TECHNOLOGY	SKILL
INSURANCE	SKILL
INSURANCE LICENSE	SKILL
INSURANCE TRACKING	SKILL
INSURANCE TRACKING COIS	SKILL
INTEGRATED CIRCUIT DESIGN AND TECHNIQUES	SKILL
INTEGRATED MARKETING COMMUNICATIONS	SKILL
INTERACTIVE MEDIA DESIGN	SKILL
INTERIOR DESIGN	SKILL
INTERMEDIATE ACCOUNTING	SKILL
INTERNATIONAL BUSINESS	SKILL
INTERNATIONAL BUSINESS OPERATIONS AND MANAGEMENT	SKILL
INTERNATIONAL RELATIONS	SKILL
INTERNATIONAL SECURITY AND TRADE	SKILL
INTERNATIONAL SECURITY GRADUATE CERTIFICATE	SKILL
INTERNATIONAL STUDIES	SKILL
INTERNATIONAL TAXATION	SKILL
INTERNET MARKETING	SKILL
INTERNET PROGRAMMING	SKILL
INVESTOR RELATIONS	SKILL
IPHONE APP DEVELOPMENT	SKILL
IT	SKILL
IT RELATED	SKILL
ITALIAN	SKILL
JAPANESE	SKILL
JAVA EE PROGRAMMING	SKILL
JAVA FOUNDATIONS	SKILL
JAVA PROGRAMMING	SKILL
JAVASCRIPT AND JQUERY	SKILL
JAVASCRIPT FOUNDATIONS	SKILL
JEWISH STUDIES	SKILL
JOURNALISM	SKILL
JUSTICE	SKILL
KINESIOLOGY	SKILL
KOREAN	SKILL
LAW	SKILL
LAW AND EXPERT WITNESS STUDIES	SKILL
LAW ENFORCEMENT	SKILL
LEADERSHIP AND MANAGEMENT EFFECTIVENESS	SKILL
LEADERSHIP FOR SUSTAINABILITY	SKILL
LEADS CERTIFICATION	SKILL
LEGAL NURSE CONSULTING	SKILL
LEGAL SECRETARY CERTIFICATE COURSE	SKILL
LGBT HUMAN SERVICES AND MENTAL HEALTH	SKILL
LIBRARIANSHIP	SKILL
LIBRARY SCIENCE	SKILL
LIFE SCIENCES	SKILL
LIGHTING	SKILL
LINGUISTICS	SKILL
LITERATURE	SKILL
LOGISTICS	SKILL
LVN	SKILL
MACHINE TOOL TECHNOLOGY	SKILL
MANAGEMENT	SKILL
MANAGEMENT SCIENCE	SKILL
MANAGEMENT SCIENCE AND ENGINEERING GRADUATE CERTIFICATE	SKILL
MANAGERIAL ACCOUNTING	SKILL
MANDARIN	SKILL
MANUFACTURING AND PRODUCT DESIGN	SKILL
MANUFACTURING ENGINEERING	SKILL
MANUFACTURING ENGINEERING TECHNOLOGY	SKILL
MANUFACTURING TECHNOLOGY	SKILL
MARKETING	SKILL
MARKETING AND COMMUNICATION	SKILL
MARKETING MANAGEMENT	SKILL
MASSAGE THERAPY	SKILL
MASTERING FRENCH GRAMMAR AND VOCABULARY	SKILL
MATERIALS SCIENCE	SKILL
MATH	SKILL
MATHEMATICAL	SKILL
MATHEMATICS	SKILL
MATHEMATICS EDUCATION	SKILL
MECHATRONIC ENGINEERING	SKILL
MECHANICAL ENGINEERING	SKILL
MECHANICAL OR ELECTRICAL ENGINEERING	SKILL
MECHANICAL TECHNOLOGY	SKILL
MECHATRONICS	SKILL
MECP CERTIFICATION	SKILL
MEDCAL LABORATORY TECHNOLOGY	SKILL
MEDIA COMMUNICATIONS	SKILL
MEDIA STUDIES	SKILL
MEDICAL ASSISTING	SKILL
MEDICAL ASSISTING AAS	SKILL
MEDICAL BILLING	SKILL
MEDICAL CASE MANAGEMENT	SKILL
MEDICAL CODING	SKILL
MEDICAL INTERPRETING	SKILL
MEDICAL PRODUCT DEVELOPMENT	SKILL
MEDICAL TECHNOLOGIST LICENSE	SKILL
MEDICAL TECHNOLOGY	SKILL
MEDICAL TERMINOLOGY	SKILL
MEDICAL TRANSCRIPTION	SKILL
MEDICAL TRANSCRIPTIONIST	SKILL
MICROBIOLOGY	SKILL
MICRO-BIOLOGY	SKILL
MICROSOFT .NET TECHNOLOGIES	SKILL
MIGRATION AND HEALTH	SKILL
MILITARY LEADERSHIP	SKILL
MIND-BODY MEDICINE	SKILL
MINING ENGINEERING	SKILL
MIS	SKILL
MOBILE APPLICATION DEVELOPMENT	SKILL
MOBILE DEVICE PROGRAMMING	SKILL
MODERN LIFESTYLE DISEASES: AWARENESS AND PREVENTION	SKILL
MOLD INSPECTION	SKILL
MOLECULAR BIOLOGY	SKILL
MOLECULAR ENGINEERING OF ENERGY TECHNOLOGIES	SKILL
MORTUARY SCIENCE	SKILL
MT ASCP	SKILL
MULTIMEDIA	SKILL
MULTIMEDIA WEB APPLICATIONS FOR TEACHERS AND TRAINERS	SKILL
MUSIC	SKILL
MUSIC BUSINESS	SKILL
MUSIC EDUCATION	SKILL
MUSIC OPTION	SKILL
MUSIC PERFORMANCE	SKILL
MUSIC RECORDING TECHNOLOGY	SKILL
MUSIC TEACHING LICENSE	SKILL
MUSIC TECHNOLOGY	SKILL
NETWORK ADMINISTRATION & SECURITY	SKILL
NETWORK CABLING SPECIALIST	SKILL
NETWORKING SYSTEMS AND TECHNOLOGY	SKILL
NETWORKS	SKILL
NEUROSCIENCE	SKILL
NEW MEDIA TECHNOLOGY	SKILL
NICHE TOURISM DEVELOPMENT	SKILL
NONPROFIT LEADERSHIP	SKILL
NUCLEAR ENGINEERING	SKILL
NURSING	SKILL
NURSING HOME ADMINISTRATION	SKILL
NUTRITION	SKILL
OBSTETRICS	SKILL
OFFICE TECHNOLOGIES	SKILL
OFFICE TECHNOLOGY	SKILL
ON-AIR	SKILL
ONLINE JOURNALISM	SKILL
ONLINE TEACHING	SKILL
ONLINE TEACHING AND LEARNING	SKILL
OPERATIONS AND SUPPLY CHAIN MANAGEMENT	SKILL
OPERATIONS MANAGEMENT	SKILL
OPTICAL ENGINEERING	SKILL
ORACLE APPLICATION DEVELOPMENT	SKILL
ORGANIZATIONAL DEVELOPMENT	SKILL
ORGANIZATIONAL LEADERSHIP & COMMUNICATION	SKILL
ORGANIZATIONAL LEADERSHIP AND COMMUNICATION	SKILL
PALLET JACKS	SKILL
PARALEGAL 	SKILL
PARAMEDIC	SKILL
PAYROLL ADMINISTRATION	SKILL
PAYROLL PRACTICE AND MANAGEMENT	SKILL
PEER SUPPORT SERVICES	SKILL
PERFORMANCE ART	SKILL
PERSONAL FINANCIAL PLANNING	SKILL
PERSONAL HEALTH AND FITNESS	SKILL
PETROLEUM ENGINEERING	SKILL
PHARMACEUTICAL SCIENCE	SKILL
PHARMACOLOGY	SKILL
PHARMACY TECHNOLOGY	SKILL
PHILOSOPHY	SKILL
PHILOSOPHY	SKILL
PHLEBOTOMY	SKILL
PHOTOGRAPHY	SKILL
PHYSICAL EDUCATION	SKILL
PHYSICS	SKILL
PHYSICS EDUCATION	SKILL
PHYSIOTHERAPY	SKILL
PLUMBING AND FIRE PROTECTION	SKILL
POLISH	SKILL
POLITICAL SCIENCE	SKILL
POLITICS	SKILL
PR	SKILL
PRACTISING ENGLISH LANGUAGE GRAMMAR SKILLS	SKILL
PRACTISING SUSTAINABLE DEVELOPMENT	SKILL
PRE-ALGEBRA MATHEMATICS	SKILL
PRE-AVIATION	SKILL
PREDICATIVE ANALYTICS	SKILL
PRE-SCHOOL EDUCATION	SKILL
PRE-SCHOOL EDUCATION/ INFANT TODDLER	SKILL
PROBABILITY AND CHANCE IN MATHEMATICS	SKILL
PROCESS TECHNOLOGY	SKILL
PROGRAMMING	SKILL
PROGRAMMING AND SYSTEMS	SKILL
PROJECT MANAGEMENT	SKILL
PROPERTY AND CASUALTY	SKILL
PSYCHIATRIC REHABILITATION	SKILL
PSYCHOLOGY	SKILL
PSYCHOSOCIAL REHABILITATION	SKILL
PTA LICENSE	SKILL
PUBLIC ADMINISTRATION	SKILL
PUBLIC HEALTH	SKILL
PUBLIC PASSENGER VEHICLE TRAINING: TAXI	SKILL
PUBLIC POLICY	SKILL
PUBLIC RELATIONS	SKILL
QUALITY ASSURANCE	SKILL
QUALITY ASSURANCE AND CONTROL	SKILL
QUALITY CONTROL TECHNOLOGY	SKILL
QUALITY MANAGEMENT WITH SIX-SIGMA BLACK BELT	SKILL
QUANTITATIVE	SKILL
QUANTITATIVE METHODS IN FINANCE GRADUATE CERTIFICATE	SKILL
RADIO PRODUCTION AND BROADCASTING	SKILL
RADIOGRAPHY	SKILL
RADIOLOGIC TECHNOLOGY	SKILL
RADIOLOGY	SKILL
RADIOLOGY TECHNOLOGY	SKILL
REAL ESTATE	SKILL
REAL ESTATE APPRAISAL	SKILL
REAL ESTATE ESCROW	SKILL
REAL ESTATE LENDING AND MORTGAGE BROKERING	SKILL
REAL ESTATE SALES	SKILL
REAL-TIME RAPID TEXT ENTRY	SKILL
RECORDS MANAGEMENT	SKILL
REFRIGERATION	SKILL
REGISTERED NURSING	SKILL
REGULATORY AFFAIRS	SKILL
REGULATORY AFFAIRS MANAGEMENT	SKILL
APPROPRIATE AREA	SKILL
APPROPRIATE  DISCIPLINE	SKILL
APPROPRIATE  DISCIPLINES	SKILL
APPROPRIATE  FIELD	SKILL
APPROPRIATE  FIELDS	SKILL
APPROPRIATE  PROGRAM	SKILL
APPROPRIATE  SUBJECT	SKILL
RELATED AREA	SKILL
RELATED DISCIPLINE	SKILL
RELATED DISCIPLINES	SKILL
RELATED FIELD	SKILL
RELATED FIELDS	SKILL
RELATED PROGRAM	SKILL
RELATED SUBJECT	SKILL
RELEVANT AREA	SKILL
RELEVANT DEGREE	SKILL
RELEVANT DISCIPLINE	SKILL
RELEVANT FIELD	SKILL
RELEVANT PROGRAM	SKILL
RELIGION	SKILL
RENAL DIALYSIS TECHNOLOGY	SKILL
RESIDENTIAL AND COMMERCIAL SUSTAINABLE PRACTICES ONLINE	SKILL
RESPIRATORY CARE	SKILL
RETAIL MANAGEMENT	SKILL
RETAILING	SKILL
RETHINKING THE PRODUCT DEVELOPMENT PROCESS	SKILL
RUSSIAN	SKILL
SAFETY AND HEALTH IN CONSTRUCTION	SKILL
SAFETY AND HEALTH IN THE TECHNOLOGY CLASSROOM FOR TEACHERS	SKILL
SAFETY FOR PROCESS TECHNOLOGY	SKILL
SAFETY MANAGEMENT	SKILL
SALES	SKILL
SALES MANAGEMENT	SKILL
SCHOOL-AGE CHILDCARE	SKILL
SCIENCES	SKILL
SCOPIST FOR COURT REPORTERS	SKILL
SEARCH ENGINE OPTIMIZATION	SKILL
SECRETARIAL SCIENCE	SKILL
SEXUAL ASSAULT EXAMINATION	SKILL
SIX SIGMA	SKILL
SIX SIGMA GREEN BELT	SKILL
SIX SIGMA LEAN	SKILL
SMALL BUSINESS MANAGEMENT	SKILL
SMALL BUSINESS MANAGEMENT/ENTREPRENEURSHIP	SKILL
SMART BUILD SYSTEMS	SKILL
SMARTER LEARNING - IMPROVE YOUR STUDY SKILLS AND PRACTICES	SKILL
SOCIAL MEDIA	SKILL
SOCIAL MEDIA MARKETING	SKILL
SOCIAL SCIENCE	SKILL
SOCIAL SCIENCE EDUCATION	SKILL
SOCIAL SCIENCES	SKILL
SOCIAL SERVICES ADDICTIONS STUDIES	SKILL
SOCIAL WORK	SKILL
SOCIAL WORK STUDIES	SKILL
SOCIOLOGY	SKILL
SOFTWARE DEVELOPMENT	SKILL
SOFTWARE ENGINEERING	SKILL
SPA AND HOSPITALITY MANAGEMENT	SKILL
SPANISH	SKILL
SPANISH EDUCATION	SKILL
SPANISH-ENGLISH TRANSLATION	SKILL
SPEAKING AND WRITING ENGLISH EFFECTIVELY	SKILL
SPECIAL EDUCATION	SKILL
SPORT SCIENCE	SKILL
SPORT SCIENCES	SKILL
SPORTS	SKILL
SPORTS SCIENCE	SKILL
SPORTS SCIENCES	SKILL
STATE AND LOCAL TAXATION	SKILL
STATISTICS	SKILL
STRATEGIC LEADERSHIP	SKILL
STRUCTURAL ANALYSIS TECHNIQUES FOR PRELIMINARY DESIGN OF LAUNCH VEHICLE STRUCTURES	SKILL
STRUCTURAL ENGINEERING	SKILL
STUDY IN WILDLAND FIRE MANAGEMENT	SKILL
SUPPLY CHAIN MANAGEMENT	SKILL
SURGICAL TECHNOLOGY	SKILL
SUSTAINABILITY BUSINESS MANAGEMENT	SKILL
SUSTAINABLE DEVELOPMENT	SKILL
SYSTEM ENGINEERING	SKILL
SYSTEMS ENGINEERING	SKILL
TAXATION	SKILL
TEACHING ADULT LEARNERS	SKILL
TEACHING ENGLISH	SKILL
TEACHING ENGLISH AS A FOREIGN LANGUAGE	SKILL
TEACHING ONLINE	SKILL
TEACHING SKILLS FOR EDUCATORS	SKILL
TECHNICAL COMMUNICATION	SKILL
TECHNICAL MARKET ANALYSIS	SKILL
TECHNICAL WRITING	SKILL
TECHNOLOGY AND LEARNING	SKILL
TELECOMMUNICATIONS	SKILL
TELECOMMUNICATIONS FUNDAMENTALS	SKILL
TELEVISION PRODUCING	SKILL
THE ECOTOURISM PLANNING & MANAGEMENT CERTIFICATE PROGRAM	SKILL
THEATER	SKILL
THEATER ART	SKILL
THEATRE	SKILL
THERAPEUTIC RECREATION	SKILL
TOXICOLOGY	SKILL
TRAINING AND DEVELOPMENT	SKILL
TRAINING IN BUSINESS ADMINISTRATION	SKILL
TRAINING IN BUSINESS TECHNOLOGY	SKILL
TRAINING IN GREAT BOOKS	SKILL
TRAINING IN LINGUISTICS	SKILL
TRANSLATION	SKILL
TURFGRASS MANAGEMENT	SKILL
TV & RADIO BROADCASTING	SKILL
TV PRODUCTION	SKILL
URBAN STUDIES	SKILL
VETERINARY TECHNOLOGY	SKILL
VIDEO JOURNALISM	SKILL
VISUAL ART	SKILL
VISUAL MEDIA COMMUNICATIONS	SKILL
WEB BUSINESS DEVELOPMENT AND MARKETING	SKILL
WEB CLIENT DEVELOPMENT	SKILL
WEB DESIGN	SKILL
WEB DESIGN AND DEVELOPMENT	SKILL
WEB DEVELOPMENT	SKILL
WEB GRAPHIC PRODUCTION	SKILL
WEB INTELLIGENCE	SKILL
WEB PROJECT MANAGEMENT	SKILL
WEB SERVER DEVELOPMENT	SKILL
WELDING	SKILL
WELDING ENGINEERING TECHNOLOGY	SKILL
WELDING TECHNOLOGY	SKILL
WINEMAKING	SKILL
WIRELESS COMMUNICATION SYSTEMS	SKILL
WIRELESS ENGINEERING	SKILL
WORD PROCESSING	SKILL
WORKPLACE SAFETY AND HEALTH	SKILL
WORKSTATION ERGONOMICS	SKILL
WRITING	SKILL
WRITING AND LITERATURE	SKILL
HISTOTECHNOLOGY	SKILL
ABILITY TO	SKILLSET
APTITUDE FOR	SKILLSET
ATTENTION TO	SKILLSET
CAPABLE OF	SKILLSET
DEMONSTRATE	SKILLSET
DEMONSTRATED	SKILLSET
EXCELLENT	SKILLSET
EXCEPTIONAL	SKILLSET
EXPERIENCE IN	SKILLSET
EXPERIENCE OF	SKILLSET
EXPERIENCE RELATED TO	SKILLSET
EXPERIENCE WITH	SKILLSET
FAMILIAR WITH	SKILLSET
FAMILIARITY WITH	SKILLSET
IS ABLE TO	SKILLSET
KNOWLEDGE ABOUT	SKILLSET
KNOWLEDGE OF	SKILLSET
MUST HAVE	SKILLSET
PROFICIENT IN	SKILLSET
PROVEN	SKILLSET
RESPONSIBILITIES INCLUDE	SKILLSET
RESPONSIBLE FOR	SKILLSET
STRONG	SKILLSET
UNDERSTANDING OF	SKILLSET
YOU WILL	SKILLSET
2D	WORKSKILL
2D CAD	WORKSKILL
3D	WORKSKILL
3D CAD	WORKSKILL
ACCOUNT MANAGEMENT	WORKSKILL
ACCOUNT MANAGEMENT SUPPORT	WORKSKILL
ADMINISTRATIVE ACTIVITIES	WORKSKILL
ADMINISTRATIVE SUPPORT	WORKSKILL
ADMINISTRATIVE TASKS	WORKSKILL
ADOBE ACROBAT	WORKSKILL
ADOBE CREATIVE SUITE	WORKSKILL
ADOBE DESIGN SUITE	WORKSKILL
ADWORDS	WORKSKILL
AGILE PROGRAMMING	WORKSKILL
AGILE SYSTEMS	WORKSKILL
AGILE TOOLS	WORKSKILL
ANALYTICAL SKILLS	WORKSKILL
ANALYTICS	WORKSKILL
ANALYZE 	WORKSKILL
ANALYZE REPORTS	WORKSKILL
ARTICULATE	WORKSKILL
ASP . NET	WORKSKILL
ASP.NET	WORKSKILL
ATTENTION TO DETAIL	WORKSKILL
AUTOCAD	WORKSKILL
B2B	WORKSKILL
BANK RECONCILIATIONS	WORKSKILL
BANKING RECONCILIATIONS	WORKSKILL
BASIC MATH SKILLS	WORKSKILL
BASIC MATHEMATICS	WORKSKILL
BASIC NUMERACY	WORKSKILL
BIG DATA	WORKSKILL
BILINGUAL	WORKSKILL
BLUEPRINTS	WORKSKILL
BUDGET PLANNING	WORKSKILL
BUDGET SUPPORT	WORKSKILL
BUDGET TRACKING	WORKSKILL
BUILDING CODES	WORKSKILL
BUILDINGLINK	WORKSKILL
BUSINESS ACUMENT	WORKSKILL
BUSINESS ANALYSIS	WORKSKILL
BUSINESS DEVELOPMENT	WORKSKILL
BUSINESS PROCESS ANALYSIS	WORKSKILL
CAD	WORKSKILL
CAREGIVING	WORKSKILL
CASE MANAGEMENT	WORKSKILL
CASH FLOW MANAGEMENT	WORKSKILL
CASHFLOW MANAGEMENT	WORKSKILL
CASH-FLOW MANAGEMENT	WORKSKILL
CATIA	WORKSKILL
CCDP	WORKSKILL
CCIP	WORKSKILL
CCNP SECURITY	WORKSKILL
CELL CULTURE	WORKSKILL
CIRCUIT DESIGN	WORKSKILL
CIVIL 3D	WORKSKILL
CLERICAL SUPPORT	WORKSKILL
COMMUNICATION ABILITY	WORKSKILL
COMMUNICATION SKILLS	WORKSKILL
COMPASSION	WORKSKILL
COMPUTER SKILLS	WORKSKILL
CONFLICT RESOLUTION	WORKSKILL
CONFLICT SITUATIONS	WORKSKILL
CONTINUOUS INTEGRATION	WORKSKILL
CONTRACT MANAGEMENT	WORKSKILL
CONTROL SYSTEMS	WORKSKILL
COOLING SYSTEMS	WORKSKILL
COURTEOUS	WORKSKILL
CREATIVE DESIGN	WORKSKILL
CREATIVE DEVELOPMENT	WORKSKILL
CREATIVE SKILLS	WORKSKILL
CSA STANDARDS	WORKSKILL
CSS	WORKSKILL
CUSTOMER DEVELOPMENT GOALS	WORKSKILL
CUSTOMER SATISFACTION	WORKSKILL
CUSTOMER SERVICE	WORKSKILL
CUSTOMER SERVICE SKILLS	WORKSKILL
CUSTOMER SUPPORT	WORKSKILL
CYTOLOGICAL MATERIALS	WORKSKILL
CYTOLOGY	WORKSKILL
DATA ANALYSIS	WORKSKILL
DATA ENTRY	WORKSKILL
DATA MODELING	WORKSKILL
DATA MODELLING	WORKSKILL
DATA VISUALIZATION SOFTWARE	WORKSKILL
DATABASE PROGRAMMING	WORKSKILL
DECISION MAKING	WORKSKILL
DETAIL ORIENTED	WORKSKILL
DEVELOP RELATIONSHIPS	WORKSKILL
DHTML	WORKSKILL
DIAGNOSIS CALCULATOR	WORKSKILL
DNA	WORKSKILL
DOCUMENTATION	WORKSKILL
DOE METHODOLOGY	WORKSKILL
DRIVER 'S LICENSE	WORKSKILL
DRIVERS LICENSE	WORKSKILL
ECG	WORKSKILL
EDITING	WORKSKILL
ENGINEERING ANALYSIS	WORKSKILL
ENGINEERING DESIGN	WORKSKILL
ENTERPRISE NETWORK ARCHITECTURE	WORKSKILL
EQUIPMENT MAINTENANCE	WORKSKILL
ERP SYSTEMS	WORKSKILL
FINANCIAL ANALYSIS	WORKSKILL
FINANCIAL FORECASTING	WORKSKILL
FINANCIAL FORECASTS	WORKSKILL
FINANCIAL REPORTING	WORKSKILL
FOIP LEGISLATION	WORKSKILL
FORECAST FINANCIAL RESULTS	WORKSKILL
FORECASTING	WORKSKILL
FORECASTING SKILLS	WORKSKILL
FRONT END DEVELOPMENT	WORKSKILL
FRONTDESKADDITION	WORKSKILL
FRONT-END DEVELOPMENT	WORKSKILL
HADOOP	WORKSKILL
HANDLE HAZARDOUS CHEMICALS	WORKSKILL
HANDLING HAZARDOUS CHECMICALS	WORKSKILL
HISTOLOGICAL MATERIALS	WORKSKILL
HISTOLOGY	WORKSKILL
HP ASE	WORKSKILL
HP MASE	WORKSKILL
IIS	WORKSKILL
IMMUNOHISTOCHEMISTRY	WORKSKILL
INROADS	WORKSKILL
INTERPERSONAL ABILITY	WORKSKILL
INTERPERSONAL COMMUNICATION	WORKSKILL
INTERPERSONAL SKILLS	WORKSKILL
INTERPRET	WORKSKILL
INTERPRET REPORTS	WORKSKILL
INVENTORY REPORTING	WORKSKILL
INVOICES	WORKSKILL
JAVA	WORKSKILL
JAVASCRIPT	WORKSKILL
JENARK	WORKSKILL
JIRA	WORKSKILL
JQUERY	WORKSKILL
JUNIPER JNCIA	WORKSKILL
KEYNOTE	WORKSKILL
LAB MAINTENANCE	WORKSKILL
LEADERSHIP	WORKSKILL
LEADERSHIP SKILLS	WORKSKILL
LITTLE SUPERVISION	WORKSKILL
LOTUS NOTES	WORKSKILL
MAINTAIN ACCURATE RECORDS	WORKSKILL
MAINTAIN DATABASE	WORKSKILL
MAINTAIN EFFECTIVE RELATIONSHIPS	WORKSKILL
MAINTAIN EQUIPMENT	WORKSKILL
MAINTAIN LAB EQUIPMENT	WORKSKILL
MAINTAIN RECORDS	WORKSKILL
MANAGEMENT REPORTING	WORKSKILL
MAPPING SOFTWARE	WORKSKILL
MEL	WORKSKILL
MERCHANDISING	WORKSKILL
MERCHANDIZING	WORKSKILL
MICROSOFT EXCEL	WORKSKILL
MICROSOFT OFFICE	WORKSKILL
MICROSOFT PROJECT	WORKSKILL
MICROSOFT WORD	WORKSKILL
MICROSTATION	WORKSKILL
MINIMAL SUPERVISION	WORKSKILL
MINIMUM SUPERVISION	WORKSKILL
MINITTAB	WORKSKILL
MONGODB	WORKSKILL
MS EXCEL	WORKSKILL
MS OFFICE	WORKSKILL
MS VISIO	WORKSKILL
MS WORD	WORKSKILL
MULTI - TASK	WORKSKILL
MULTI - TASKING	WORKSKILL
MULTITASK	WORKSKILL
MULTI-TASK	WORKSKILL
MULTITASKING	WORKSKILL
MULTI-TASKING	WORKSKILL
NCIE	WORKSKILL
NEGOTIATING SKILLS	WORKSKILL
NEGOTIATION SKILLS	WORKSKILL
NETWORK ARCHITECTURE	WORKSKILL
NO SUPERVISION	WORKSKILL
NOSQL	WORKSKILL
NOTEWRITER	WORKSKILL
ORACLE	WORKSKILL
ORGANIZATIONAL SKILLS	WORKSKILL
ORGANIZING SKILLS	WORKSKILL
OS ARCHITECTURE	WORKSKILL
OSCILLOSCOPES	WORKSKILL
PAAS	WORKSKILL
PAYROLL	WORKSKILL
PEOPLESOFT	WORKSKILL
PERSONALIZED SERVICE	WORKSKILL
PHOTOSHOP	WORKSKILL
PHP	WORKSKILL
PIVOTAL TRACKER	WORKSKILL
PLANNING SKILLS	WORKSKILL
PLSQL	WORKSKILL
POS SYSTEM	WORKSKILL
POSITIVE RELATIONSHIPS	WORKSKILL
POWERPOINT	WORKSKILL
POWERSHELL	WORKSKILL
PRACTICAL PROCESS IMPROVEMENT	WORKSKILL
PREPARE FINANCIAL STATEMENTS	WORKSKILL
PREPARE RFPS	WORKSKILL
PREPARES FINANCIAL STATEMENTS	WORKSKILL
PREPARING FINANCIAL STATEMENTS	WORKSKILL
PREPARING STAINS	WORKSKILL
PRESENTATION ABILITY	WORKSKILL
PRESENTATION SKILLS	WORKSKILL
PROBLEM SOLVING	WORKSKILL
PROBLEM-ORIENTED CHARTING	WORKSKILL
PROCUREMENT	WORKSKILL
PROJECT MANAGEMENT ABILITY	WORKSKILL
PROJECT MANAGEMENT SKILLS	WORKSKILL
PROOFREAD	WORKSKILL
PROPERTY MANAGEMENT	WORKSKILL
PROTOTYPING	WORKSKILL
PROVIDE ESTIMATES	WORKSKILL
PROVIDING ESTIMATES	WORKSKILL
PUPPET	WORKSKILL
PYTHON	WORKSKILL
QSR	WORKSKILL
QS-STAT	WORKSKILL
QUARKXPRESS	WORKSKILL
RAPPORT	WORKSKILL
REPORTING INVENTORY	WORKSKILL
REQUEST FOR PROPOSALS	WORKSKILL
REQUIREMENTS GATHERING	WORKSKILL
RESOLVE CONFLICTS	WORKSKILL
RFP PREPARATION	WORKSKILL
RNA	WORKSKILL
RPLAN	WORKSKILL
RUBY	WORKSKILL
RUBY ON RAILS	WORKSKILL
SALES FORECASTING	WORKSKILL
SALES FORECASTS	WORKSKILL
SALES GOALS	WORKSKILL
SALES SUPPORT	WORKSKILL
SALES TARGET	WORKSKILL
SALES TARGETS	WORKSKILL
SAP	WORKSKILL
SEO	WORKSKILL
SHAREPOINT	WORKSKILL
SMARTTOOLS	WORKSKILL
SOLIDWORKS	WORKSKILL
SOLVE PRACTICAL PROBLEMS	WORKSKILL
SOLVE PROBLEMS	WORKSKILL
SOUND JUDGEMENT	WORKSKILL
SPREADSHEETS	WORKSKILL
SQL	WORKSKILL
STAINING	WORKSKILL
STRATEGIC DECISION MAKING	WORKSKILL
STRATEGIC PLANNING	WORKSKILL
STRATEGIC THINKER	WORKSKILL
STRESS MANAGEMENT	WORKSKILL
STRESSFUL	WORKSKILL
SYSTEM ARCHITECTURE	WORKSKILL
SYSTEMS ARCHITECTURE	WORKSKILL
TEAM ORIENTED	WORKSKILL
TEAM PLAYER	WORKSKILL
TEAM WORK	WORKSKILL
TEAMWORK	WORKSKILL
TECHNICAL DESIGN	WORKSKILL
TECHNICAL DESIGN SPECIFICATIONS	WORKSKILL
TECHNICAL SUPPORT	WORKSKILL
TIME MANAGEMENT	WORKSKILL
TROUBLESHOOTING	WORKSKILL
UI	WORKSKILL
UX	WORKSKILL
UX PROCESS	WORKSKILL
UX PROCESSES	WORKSKILL
VERBAL COMMUNICATION SKILLS	WORKSKILL
WEB PROGRAMMING	WORKSKILL
WEBAPI	WORKSKILL
WELDING CODES	WORKSKILL
WORK COLLABORATIVELY	WORKSKILL
WORK UNDER PRESSURE	WORKSKILL
WORKING UNDER PRESSURE	WORKSKILL
WRITTEN COMMUNICATION SKILLS	WORKSKILL
XML	WORKSKILL
ZENHUB	WORKSKILL
YOU MUST	SKILLSET
DELIVERY DRIVER	JOBTITLE
SALES CONSULTANT	JOBTITLE
LEASING CONSULTANT	JOBTITLE
TRUCK DRIVER	JOBTITLE
BRAND AMBASSADOR	JOBTITLE
PAYROLL ADMINISTRATOR	JOBTITLE
BEAUTY CONSULTANT	JOBTITLE
PRODUCTION WORKER	JOBTITLE
CREDIT ANALYST	JOBTITLE
ROUTE DRIVER	JOBTITLE
TECHNICAL RECRUITER	JOBTITLE
PROPERTY ADMINISTRATOR	JOBTITLE
NURSE SUPERVISOR	JOBTITLE
RECRUITING MANAGER	JOBTITLE
PHP DEVELOPER	JOBTITLE
MECHANIC TECHNICIAN	JOBTITLE
FIRE TECHNICIAN	JOBTITLE
SOCIAL MEDIA MANAGER	JOBTITLE
RECRUITMENT CONSULTANT	JOBTITLE
LUBE TECHNICIAN	JOBTITLE
VISUAL DESIGNER	JOBTITLE
BAR MANAGER	JOBTITLE
CNC OPERATOR	JOBTITLE
FINANCIAL CONSULTANT	JOBTITLE
IOS DEVELOPER	JOBTITLE
FIELD MANAGER	JOBTITLE
UI DEVELOPER	JOBTITLE
UNIT CLERK	JOBTITLE
AUTOMOTIVE SALES CONSULTANT	JOBTITLE
SHIPPING CLERK	JOBTITLE
IRRIGATION TECHNICIAN	JOBTITLE
LOAN CONSULTANT	JOBTITLE
PRODUCT ADVISOR	JOBTITLE
CUSTOMER SUPPORT SPECIALIST	JOBTITLE
MAINTENANCE ASSISTANT	JOBTITLE
FIELD SUPERVISOR	JOBTITLE
FINANCIAL COUNSELOR	JOBTITLE
MAINTENANCE ENGINEER	JOBTITLE
ACCOUNT SPECIALIST	JOBTITLE
ARCHITECTURAL DESIGNER	JOBTITLE
ASSOCIATE BUYER	JOBTITLE
PRODUCT DESIGNER	JOBTITLE
MERCHANDISING MANAGER	JOBTITLE
LOGISTICS MANAGER	JOBTITLE
HADOOP DEVELOPER	JOBTITLE
MARKET MANAGER	JOBTITLE
FINANCE AND INSURANCE MANAGER	JOBTITLE
DINING ROOM MANAGER	JOBTITLE
BENEFITS ADMINISTRATOR	JOBTITLE
INVENTORY CLERK	JOBTITLE
HEALTHCARE EXECUTIVE	JOBTITLE
ELECTRICAL TECHNICIAN	JOBTITLE
MANUFACTURING TECHNICIAN	JOBTITLE
JAVASCRIPT DEVELOPER	JOBTITLE
DEPUTY DIRECTOR	JOBTITLE
DESIGN CONSULTANT	JOBTITLE
MANAGER TRAINEE	JOBTITLE
HR RECRUITER	JOBTITLE
TIRE TECHNICIAN	JOBTITLE
MAINTENANCE MECHANIC	JOBTITLE
HR DIRECTOR	JOBTITLE
CNC MACHINING TOOL OPERATOR	JOBTITLE
ASSISTANT CULINARY MANAGER	JOBTITLE
PHYSICAL THERAPY AIDE	JOBTITLE
ASSISTANT DESIGNER	JOBTITLE
STAFFING MANAGER	JOBTITLE
MECHANICAL TECHNICIAN	JOBTITLE
AUTO TECHNICIAN	JOBTITLE
ACADEMIC ADVISOR	JOBTITLE
GENETIC COUNSELOR	JOBTITLE
SALES LEAD	JOBTITLE
BUILDING OPERATOR	JOBTITLE
NURSING MANAGER	JOBTITLE
DIETITIAN NUTRITIONIST	JOBTITLE
ELECTRONIC TECHNICIAN	JOBTITLE
SALESFORCE DEVELOPER	JOBTITLE
FRONT DESK MANAGER	JOBTITLE
LAW CLERK	JOBTITLE
MORTGAGE UNDERWRITER	JOBTITLE
ACCOUNTING SUPERVISOR	JOBTITLE
HOUSEKEEPING AIDE	JOBTITLE
PROJECT ARCHITECT	JOBTITLE
FITNESS CONSULTANT	JOBTITLE
AUDIO VISUAL TECHNICIAN	JOBTITLE
REVENUE MANAGER	JOBTITLE
BUILDING INSPECTOR	JOBTITLE
APPRENTICE TECHNICIAN	JOBTITLE
ACCOUNTING ANALYST	JOBTITLE
KITCHEN SUPERVISOR	JOBTITLE
CONTENT WRITER	JOBTITLE
HUMAN RESOURCE GENERALIST	JOBTITLE
CLIENT MANAGER	JOBTITLE
TEST ENGINEER	JOBTITLE
BANQUET MANAGER	JOBTITLE
CONSTRUCTION INSPECTOR	JOBTITLE
